"txt","person","inDegree","outDegree","betweenness","totalDegree","timeperiod","timeperiodNum"
"38","amatsuda","4","2","142","6","comments-fixed.csv","0"
NA,"Arsen7","1","1","0","2","comments-fixed.csv","0"
NA,"arunagw","1","1","0","2","comments-fixed.csv","0"
NA,"bogdan","7","4","239","11","comments-fixed.csv","0"
NA,"bradediger","1","1","0","2","comments-fixed.csv","0"
NA,"butcher","4","1","24","5","comments-fixed.csv","0"
NA,"carlosantoniodasilva","1","2","0","3","comments-fixed.csv","0"
NA,"dasch","1","1","100","2","comments-fixed.csv","0"
NA,"dmathieu","4","3","173","7","comments-fixed.csv","0"
NA,"fxn","0","2","0","2","comments-fixed.csv","0"
NA,"guilleiguaran","7","16","309.666666666667","23","comments-fixed.csv","0"
NA,"idoru","0","1","0","1","comments-fixed.csv","0"
NA,"isaacsanders","7","8","237.333333333333","15","comments-fixed.csv","0"
NA,"jasonnoble","0","1","0","1","comments-fixed.csv","0"
NA,"jeremy","1","1","0","2","comments-fixed.csv","0"
NA,"jonleighton","3","2","4","5","comments-fixed.csv","0"
NA,"josevalim","5","12","323.333333333333","17","comments-fixed.csv","0"
NA,"josh","1","0","0","1","comments-fixed.csv","0"
NA,"lautis","1","1","0","2","comments-fixed.csv","0"
NA,"marcofognog","0","1","0","1","comments-fixed.csv","0"
NA,"paneq","5","2","108","7","comments-fixed.csv","0"
NA,"pivotal-casebook","6","0","0","6","comments-fixed.csv","0"
NA,"pixeltrix","2","4","70","6","comments-fixed.csv","0"
NA,"rafaelfranca","0","3","0","3","comments-fixed.csv","0"
NA,"ragaskar","1","1","0","2","comments-fixed.csv","0"
NA,"route","0","1","0","1","comments-fixed.csv","0"
NA,"rsim","0","3","0","3","comments-fixed.csv","0"
NA,"rupurt","0","1","0","1","comments-fixed.csv","0"
NA,"siong1987","2","2","0","4","comments-fixed.csv","0"
NA,"spastorino","6","5","1.63636363636364","11","comments-fixed.csv","0"
NA,"steveklabnik","2","4","0","6","comments-fixed.csv","0"
NA,"tekwiz","1","1","7.66666666666667","2","comments-fixed.csv","0"
NA,"tenderlove","14","3","258.030303030303","17","comments-fixed.csv","0"
NA,"thedarkone","1","1","0","2","comments-fixed.csv","0"
NA,"thinkerbot","3","1","22.6666666666667","4","comments-fixed.csv","0"
NA,"toddboom","0","1","0","1","comments-fixed.csv","0"
NA,"vijaydev","2","1","196.666666666667","3","comments-fixed.csv","0"
NA,"wycats","1","0","0","1","comments-fixed.csv","0"
"77","aaronchi","3","1","18.5","4","comments-fixed.csv","1"
NA,"abachman","0","1","0","1","comments-fixed.csv","1"
NA,"adrpac","0","1","0","1","comments-fixed.csv","1"
NA,"artemave","13","1","351","14","comments-fixed.csv","1"
NA,"arunagw","3","6","283.490326556627","9","comments-fixed.csv","1"
NA,"betelgeuse","2","1","38","3","comments-fixed.csv","1"
NA,"brendon","0","2","0","2","comments-fixed.csv","1"
NA,"brianmario","0","1","0","1","comments-fixed.csv","1"
NA,"btelles","0","1","0","1","comments-fixed.csv","1"
NA,"carlosantoniodasilva","3","2","117.432750799051","5","comments-fixed.csv","1"
NA,"cgriego","7","3","275.019696969697","10","comments-fixed.csv","1"
NA,"chriseppstein","0","1","0","1","comments-fixed.csv","1"
NA,"christianblais","4","0","0","4","comments-fixed.csv","1"
NA,"ChristianPeters","0","1","0","1","comments-fixed.csv","1"
NA,"derekprior","4","4","115.452447768748","8","comments-fixed.csv","1"
NA,"dhh","3","0","0","3","comments-fixed.csv","1"
NA,"dmathieu","11","8","600.122023045817","19","comments-fixed.csv","1"
NA,"elomarns","0","1","0","1","comments-fixed.csv","1"
NA,"et","0","1","0","1","comments-fixed.csv","1"
NA,"frodsan","0","2","0","2","comments-fixed.csv","1"
NA,"fxn","4","3","5.18069036226931","7","comments-fixed.csv","1"
NA,"grosser","0","1","0","1","comments-fixed.csv","1"
NA,"guilleiguaran","33","32","898.962969689992","65","comments-fixed.csv","1"
NA,"hzeus","0","1","0","1","comments-fixed.csv","1"
NA,"isaacsanders","1","1","0","2","comments-fixed.csv","1"
NA,"ivanvanderbyl","1","1","0","2","comments-fixed.csv","1"
NA,"jeremyevans","0","2","0","2","comments-fixed.csv","1"
NA,"jeremyf","0","1","0","1","comments-fixed.csv","1"
NA,"joeljunstrom","1","2","0","3","comments-fixed.csv","1"
NA,"jonleighton","9","7","1130.43638604214","16","comments-fixed.csv","1"
NA,"josevalim","10","19","651.169323816482","29","comments-fixed.csv","1"
NA,"josh","7","8","30.5369068919804","15","comments-fixed.csv","1"
NA,"jsanders","1","1","0","2","comments-fixed.csv","1"
NA,"kirel","0","1","0","1","comments-fixed.csv","1"
NA,"kirs","2","2","18.5","4","comments-fixed.csv","1"
NA,"KlausTrainer","1","1","0","2","comments-fixed.csv","1"
NA,"kule","0","1","0","1","comments-fixed.csv","1"
NA,"markembling","2","3","0","5","comments-fixed.csv","1"
NA,"mbravorus","0","1","0","1","comments-fixed.csv","1"
NA,"mirceapricop","0","1","0","1","comments-fixed.csv","1"
NA,"moiristo","0","1","0","1","comments-fixed.csv","1"
NA,"mtoledo","1","0","0","1","comments-fixed.csv","1"
NA,"nateware","0","1","0","1","comments-fixed.csv","1"
NA,"nbarthelemy","1","2","0","3","comments-fixed.csv","1"
NA,"NiFi","0","1","0","1","comments-fixed.csv","1"
NA,"Ninju","1","1","0","2","comments-fixed.csv","1"
NA,"NZKoz","2","0","0","2","comments-fixed.csv","1"
NA,"ohwillie","0","1","0","1","comments-fixed.csv","1"
NA,"oscardelben","0","1","0","1","comments-fixed.csv","1"
NA,"osegrums","0","1","0","1","comments-fixed.csv","1"
NA,"parndt","7","8","291.927544351074","15","comments-fixed.csv","1"
NA,"pcg79","0","1","0","1","comments-fixed.csv","1"
NA,"pdelanauze","0","1","0","1","comments-fixed.csv","1"
NA,"pixeltrix","3","2","167","5","comments-fixed.csv","1"
NA,"pwim","0","1","0","1","comments-fixed.csv","1"
NA,"radar","1","1","0","2","comments-fixed.csv","1"
NA,"rafaelfranca","4","11","603.224747474748","15","comments-fixed.csv","1"
NA,"raggi","0","1","0","1","comments-fixed.csv","1"
NA,"reqorder","0","1","0","1","comments-fixed.csv","1"
NA,"rhulse","2","4","8.09974937343358","6","comments-fixed.csv","1"
NA,"seanabrahams","0","1","0","1","comments-fixed.csv","1"
NA,"shwoodard","7","1","308","8","comments-fixed.csv","1"
NA,"sikachu","1","1","0","2","comments-fixed.csv","1"
NA,"spagalioco","2","5","0","7","comments-fixed.csv","1"
NA,"spastorino","14","8","388.76512079443","22","comments-fixed.csv","1"
NA,"spohlenz","5","11","135.151649090157","16","comments-fixed.csv","1"
NA,"sr3d","0","1","0","1","comments-fixed.csv","1"
NA,"tarikjn","1","1","0","2","comments-fixed.csv","1"
NA,"tenderlove","8","2","149.037862786765","10","comments-fixed.csv","1"
NA,"Tho85","16","4","534.781890331891","20","comments-fixed.csv","1"
NA,"tiegz","0","3","0","3","comments-fixed.csv","1"
NA,"TildeWill","1","0","0","1","comments-fixed.csv","1"
NA,"travisp","0","1","0","1","comments-fixed.csv","1"
NA,"unimatrixZxero","0","1","0","1","comments-fixed.csv","1"
NA,"vijaydev","3","5","42.8253104053794","8","comments-fixed.csv","1"
NA,"yaroslav","0","1","0","1","comments-fixed.csv","1"
NA,"zenprogrammer","19","11","747.38260344932","30","comments-fixed.csv","1"
"35","bestie","3","3","0","6","comments-fixed.csv","2"
NA,"bobbytables","2","0","0","2","comments-fixed.csv","2"
NA,"bogdan","9","0","0","9","comments-fixed.csv","2"
NA,"dasch","1","6","12","7","comments-fixed.csv","2"
NA,"davidknezic","0","1","0","1","comments-fixed.csv","2"
NA,"dbenhur","1","1","0","2","comments-fixed.csv","2"
NA,"dmitriy-kiriyenko","1","3","0","4","comments-fixed.csv","2"
NA,"dmitry","0","1","0","1","comments-fixed.csv","2"
NA,"eparreno","1","0","0","1","comments-fixed.csv","2"
NA,"fxn","2","2","23.6666666666667","4","comments-fixed.csv","2"
NA,"gmcnaughton","0","1","0","1","comments-fixed.csv","2"
NA,"guilleiguaran","8","5","75","13","comments-fixed.csv","2"
NA,"homakov","0","3","0","3","comments-fixed.csv","2"
NA,"isaacsanders","2","5","92","7","comments-fixed.csv","2"
NA,"jacobo","6","2","21","8","comments-fixed.csv","2"
NA,"jeremy","4","3","8.33333333333333","7","comments-fixed.csv","2"
NA,"joevandyk","3","3","46","6","comments-fixed.csv","2"
NA,"jonleighton","5","3","26.8333333333333","8","comments-fixed.csv","2"
NA,"josevalim","9","13","156.166666666667","22","comments-fixed.csv","2"
NA,"jwulff","0","2","0","2","comments-fixed.csv","2"
NA,"kennyj","1","1","0","2","comments-fixed.csv","2"
NA,"larzconwell","1","4","0","5","comments-fixed.csv","2"
NA,"lawrencepit","8","5","39","13","comments-fixed.csv","2"
NA,"monde","1","1","0","2","comments-fixed.csv","2"
NA,"oggy","3","0","0","3","comments-fixed.csv","2"
NA,"rafaelfranca","0","1","0","1","comments-fixed.csv","2"
NA,"seanwalbran","1","1","0","2","comments-fixed.csv","2"
NA,"sobrinho","0","2","0","2","comments-fixed.csv","2"
NA,"spastorino","1","0","0","1","comments-fixed.csv","2"
NA,"steveklabnik","2","2","0","4","comments-fixed.csv","2"
NA,"tenderlove","3","0","0","3","comments-fixed.csv","2"
NA,"thomasfedb","0","1","0","1","comments-fixed.csv","2"
NA,"vijaydev","1","3","0","4","comments-fixed.csv","2"
NA,"vjt","0","1","0","1","comments-fixed.csv","2"
NA,"willbryant","2","2","24","4","comments-fixed.csv","2"
"43","amatsuda","18","8","369.749142524143","26","comments-fixed.csv","3"
NA,"bfolkens","1","0","0","1","comments-fixed.csv","3"
NA,"blakeeb","2","1","24","3","comments-fixed.csv","3"
NA,"bogdan","2","2","0","4","comments-fixed.csv","3"
NA,"brentsowers1","0","2","0","2","comments-fixed.csv","3"
NA,"carlosantoniodasilva","1","1","0","2","comments-fixed.csv","3"
NA,"chriseppstein","6","7","0","13","comments-fixed.csv","3"
NA,"danielvlopes","1","2","0","3","comments-fixed.csv","3"
NA,"derekprior","5","3","72","8","comments-fixed.csv","3"
NA,"dvyjones","2","2","23","4","comments-fixed.csv","3"
NA,"fxn","5","4","130.444444444444","9","comments-fixed.csv","3"
NA,"gregolsen","7","2","74","9","comments-fixed.csv","3"
NA,"guilleiguaran","16","6","217.107575757576","22","comments-fixed.csv","3"
NA,"isaacsanders","0","1","0","1","comments-fixed.csv","3"
NA,"jdelStrother","13","11","122","24","comments-fixed.csv","3"
NA,"jeremy","2","5","84","7","comments-fixed.csv","3"
NA,"jfirebaugh","0","1","0","1","comments-fixed.csv","3"
NA,"joevandyk","1","2","0","3","comments-fixed.csv","3"
NA,"jonleighton","5","10","126.5","15","comments-fixed.csv","3"
NA,"josevalim","18","24","520.750108225108","42","comments-fixed.csv","3"
NA,"jrochkind","1","1","0","2","comments-fixed.csv","3"
NA,"kjohnston","0","1","0","1","comments-fixed.csv","3"
NA,"krainboltgreene","7","4","114.087337662338","11","comments-fixed.csv","3"
NA,"lest","0","1","0","1","comments-fixed.csv","3"
NA,"mkdynamic","0","1","0","1","comments-fixed.csv","3"
NA,"nashby","4","4","56.1281662781663","8","comments-fixed.csv","3"
NA,"parndt","1","0","0","1","comments-fixed.csv","3"
NA,"paulschreiber","0","1","0","1","comments-fixed.csv","3"
NA,"qoobaa","0","1","0","1","comments-fixed.csv","3"
NA,"rafaelfranca","0","1","0","1","comments-fixed.csv","3"
NA,"rapind","0","1","0","1","comments-fixed.csv","3"
NA,"robgleeson","1","1","0","2","comments-fixed.csv","3"
NA,"ryanlecompte","4","1","24","5","comments-fixed.csv","3"
NA,"spastorino","0","1","0","1","comments-fixed.csv","3"
NA,"splattael","2","2","0","4","comments-fixed.csv","3"
NA,"stevenh512","0","1","0","1","comments-fixed.csv","3"
NA,"taelor","0","1","0","1","comments-fixed.csv","3"
NA,"taq","0","1","0","1","comments-fixed.csv","3"
NA,"tenderlove","4","3","88.0954545454545","7","comments-fixed.csv","3"
NA,"vijaydev","6","8","183.137770562771","14","comments-fixed.csv","3"
NA,"wsouto","0","3","0","3","comments-fixed.csv","3"
NA,"wxianfeng","0","1","0","1","comments-fixed.csv","3"
NA,"wycats","0","2","0","2","comments-fixed.csv","3"
"46","alexeymuranov","14","23","192.41381146217","37","comments-fixed.csv","4"
NA,"amatsuda","3","0","0","3","comments-fixed.csv","4"
NA,"Antiarchitect","14","4","225.704069264069","18","comments-fixed.csv","4"
NA,"arunagw","10","11","56.3970099527023","21","comments-fixed.csv","4"
NA,"Bazai","0","1","0","1","comments-fixed.csv","4"
NA,"benmmurphy","7","7","152","14","comments-fixed.csv","4"
NA,"bogdan","2","0","0","2","comments-fixed.csv","4"
NA,"borisd","3","0","0","3","comments-fixed.csv","4"
NA,"carlosantoniodasilva","2","5","48.3968831168831","7","comments-fixed.csv","4"
NA,"carlosramireziii","0","1","0","1","comments-fixed.csv","4"
NA,"drogus","5","8","105.10870789672","13","comments-fixed.csv","4"
NA,"dvyjones","2","2","0","4","comments-fixed.csv","4"
NA,"egilburg","0","2","0","2","comments-fixed.csv","4"
NA,"freegenie","1","1","0","2","comments-fixed.csv","4"
NA,"fxn","4","1","0","5","comments-fixed.csv","4"
NA,"gazay","3","2","97","5","comments-fixed.csv","4"
NA,"guilleiguaran","7","10","182.867811934901","17","comments-fixed.csv","4"
NA,"isaacsanders","2","5","49.8311688311688","7","comments-fixed.csv","4"
NA,"jcoleman","1","0","0","1","comments-fixed.csv","4"
NA,"jdelStrother","4","0","0","4","comments-fixed.csv","4"
NA,"jeremy","1","2","36.5","3","comments-fixed.csv","4"
NA,"jonleighton","17","5","1.45197319434103","22","comments-fixed.csv","4"
NA,"josevalim","20","25","527.402390675429","45","comments-fixed.csv","4"
NA,"juwalter","1","1","0","2","comments-fixed.csv","4"
NA,"kevinzen","0","1","0","1","comments-fixed.csv","4"
NA,"kirs","1","2","0","3","comments-fixed.csv","4"
NA,"KODerFunk","0","1","0","1","comments-fixed.csv","4"
NA,"kommen","2","2","0","4","comments-fixed.csv","4"
NA,"lawrencepit","1","2","0","3","comments-fixed.csv","4"
NA,"lest","4","9","110.424588744589","13","comments-fixed.csv","4"
NA,"mferrier","0","1","0","1","comments-fixed.csv","4"
NA,"nashby","15","10","115.477661789687","25","comments-fixed.csv","4"
NA,"orslumen","0","1","0","1","comments-fixed.csv","4"
NA,"parndt","0","1","0","1","comments-fixed.csv","4"
NA,"pdjota","2","2","0","4","comments-fixed.csv","4"
NA,"pederbl","1","0","0","1","comments-fixed.csv","4"
NA,"petervandenabeele","2","2","2.92857142857143","4","comments-fixed.csv","4"
NA,"qoobaa","0","1","0","1","comments-fixed.csv","4"
NA,"rafaelfranca","0","2","0","2","comments-fixed.csv","4"
NA,"rdp","1","0","0","1","comments-fixed.csv","4"
NA,"sferik","0","1","0","1","comments-fixed.csv","4"
NA,"spastorino","1","1","54","2","comments-fixed.csv","4"
NA,"steveklabnik","0","2","0","2","comments-fixed.csv","4"
NA,"tenderlove","12","8","393.554918808336","20","comments-fixed.csv","4"
NA,"vijaydev","8","8","70.2070995670996","16","comments-fixed.csv","4"
NA,"wycats","2","2","1.33333333333333","4","comments-fixed.csv","4"
"47","aceofspades","1","1","33","2","comments-fixed.csv","5"
NA,"alexeymuranov","9","10","182.987365901325","19","comments-fixed.csv","5"
NA,"amatsuda","11","4","84.9839799089799","15","comments-fixed.csv","5"
NA,"arunagw","3","4","82.9666666666667","7","comments-fixed.csv","5"
NA,"bogdan","5","4","46.9405693721483","9","comments-fixed.csv","5"
NA,"brentsowers1","0","1","0","1","comments-fixed.csv","5"
NA,"carlosantoniodasilva","13","20","463.262392845808","33","comments-fixed.csv","5"
NA,"danchoi","3","3","96","6","comments-fixed.csv","5"
NA,"despo","0","1","0","1","comments-fixed.csv","5"
NA,"dmathieu","2","1","3.10897990897991","3","comments-fixed.csv","5"
NA,"dnagir","0","1","0","1","comments-fixed.csv","5"
NA,"drogus","0","1","0","1","comments-fixed.csv","5"
NA,"elia","4","5","136","9","comments-fixed.csv","5"
NA,"frodsan","1","2","0","3","comments-fixed.csv","5"
NA,"fu-media","0","1","0","1","comments-fixed.csv","5"
NA,"fxn","2","0","0","2","comments-fixed.csv","5"
NA,"gregolsen","4","1","7.05555555555556","5","comments-fixed.csv","5"
NA,"guilleiguaran","10","5","131.014584956048","15","comments-fixed.csv","5"
NA,"huerlisi","0","1","0","1","comments-fixed.csv","5"
NA,"iHiD","4","2","57.0978682170542","6","comments-fixed.csv","5"
NA,"isaacsanders","1","1","0","2","comments-fixed.csv","5"
NA,"j-manu","6","6","128","12","comments-fixed.csv","5"
NA,"jasonnoble","1","1","0","2","comments-fixed.csv","5"
NA,"jdelStrother","2","1","7.6783723522854","3","comments-fixed.csv","5"
NA,"jeremy","10","5","145.870046620047","15","comments-fixed.csv","5"
NA,"jm","3","1","0.333333333333333","4","comments-fixed.csv","5"
NA,"joevandyk","0","1","0","1","comments-fixed.csv","5"
NA,"jonleighton","8","11","138.887223296663","19","comments-fixed.csv","5"
NA,"josevalim","15","26","456.164692421052","41","comments-fixed.csv","5"
NA,"jrochkind","2","2","0","4","comments-fixed.csv","5"
NA,"jwarchol","1","1","0","2","comments-fixed.csv","5"
NA,"lawrencepit","2","1","0","3","comments-fixed.csv","5"
NA,"lest","3","3","47.5222222222222","6","comments-fixed.csv","5"
NA,"mikelikesbikes","0","2","0","2","comments-fixed.csv","5"
NA,"mipearson","1","1","0","2","comments-fixed.csv","5"
NA,"nashby","2","0","0","2","comments-fixed.csv","5"
NA,"nfm","0","1","0","1","comments-fixed.csv","5"
NA,"rafaelfranca","7","10","146.442016167975","17","comments-fixed.csv","5"
NA,"simonc","0","1","0","1","comments-fixed.csv","5"
NA,"spastorino","2","1","0","3","comments-fixed.csv","5"
NA,"splattael","0","1","0","1","comments-fixed.csv","5"
NA,"steveklabnik","0","1","0","1","comments-fixed.csv","5"
NA,"swrobel","2","4","0","6","comments-fixed.csv","5"
NA,"tenderlove","18","7","283.789886167676","25","comments-fixed.csv","5"
NA,"vijaydev","3","4","16.8942440861811","7","comments-fixed.csv","5"
NA,"wycats","1","0","0","1","comments-fixed.csv","5"
NA,"xuanxu","0","1","0","1","comments-fixed.csv","5"
"61","AaronLasseigne","0","1","0","1","comments-fixed.csv","6"
NA,"alexeymuranov","2","0","0","2","comments-fixed.csv","6"
NA,"arunagw","3","0","0","3","comments-fixed.csv","6"
NA,"benmmurphy","4","2","0","6","comments-fixed.csv","6"
NA,"blackbird07","1","2","0","3","comments-fixed.csv","6"
NA,"bogdan","6","4","95","10","comments-fixed.csv","6"
NA,"bradediger","4","2","46","6","comments-fixed.csv","6"
NA,"canweriotnow","0","1","0","1","comments-fixed.csv","6"
NA,"carlosantoniodasilva","12","9","216.149062049062","21","comments-fixed.csv","6"
NA,"chris-baynes","3","3","0","6","comments-fixed.csv","6"
NA,"conradwt","1","1","0","2","comments-fixed.csv","6"
NA,"dlee","10","5","321","15","comments-fixed.csv","6"
NA,"drogus","1","2","37.4090909090909","3","comments-fixed.csv","6"
NA,"frodsan","0","1","0","1","comments-fixed.csv","6"
NA,"funny-falcon","2","1","0","3","comments-fixed.csv","6"
NA,"fxn","9","13","643.108021390374","22","comments-fixed.csv","6"
NA,"gregolsen","1","1","0","2","comments-fixed.csv","6"
NA,"guilleiguaran","5","10","114.253968253968","15","comments-fixed.csv","6"
NA,"headius","1","0","0","1","comments-fixed.csv","6"
NA,"hmcfletch","6","2","255.857575757576","8","comments-fixed.csv","6"
NA,"homakov","3","2","46","5","comments-fixed.csv","6"
NA,"houen","0","1","0","1","comments-fixed.csv","6"
NA,"igrigorik","1","0","0","1","comments-fixed.csv","6"
NA,"iHiD","2","3","0","5","comments-fixed.csv","6"
NA,"indrekj","0","1","0","1","comments-fixed.csv","6"
NA,"isaacsanders","1","7","5.2804662004662","8","comments-fixed.csv","6"
NA,"jeremy","4","3","105.071861471861","7","comments-fixed.csv","6"
NA,"jeremyf","1","7","64.8787878787879","8","comments-fixed.csv","6"
NA,"jkaneacumen","0","2","0","2","comments-fixed.csv","6"
NA,"joevandyk","9","8","108.873303167421","17","comments-fixed.csv","6"
NA,"jonleighton","9","2","125.095989304813","11","comments-fixed.csv","6"
NA,"josevalim","19","24","891.997705627706","43","comments-fixed.csv","6"
NA,"kennyj","19","17","1143.17724980901","36","comments-fixed.csv","6"
NA,"kreynolds","2","0","0","2","comments-fixed.csv","6"
NA,"lest","1","3","0","4","comments-fixed.csv","6"
NA,"lloeki","0","1","0","1","comments-fixed.csv","6"
NA,"markiz","1","3","0","4","comments-fixed.csv","6"
NA,"masterkain","0","2","0","2","comments-fixed.csv","6"
NA,"Mik-die","1","0","0","1","comments-fixed.csv","6"
NA,"mledom","1","1","0","2","comments-fixed.csv","6"
NA,"nashby","2","3","12.6773262032086","5","comments-fixed.csv","6"
NA,"ncreuschling","1","1","0","2","comments-fixed.csv","6"
NA,"nicksieger","1","0","0","1","comments-fixed.csv","6"
NA,"NZKoz","6","9","195.166666666667","15","comments-fixed.csv","6"
NA,"parndt","3","2","80.4171122994652","5","comments-fixed.csv","6"
NA,"patrick99e99","7","6","159.717766351296","13","comments-fixed.csv","6"
NA,"paukul","1","0","0","1","comments-fixed.csv","6"
NA,"Pliny","2","1","0","3","comments-fixed.csv","6"
NA,"radar","0","2","0","2","comments-fixed.csv","6"
NA,"rafaelfranca","4","7","269.055498096675","11","comments-fixed.csv","6"
NA,"rinaldifonseca","2","1","0","3","comments-fixed.csv","6"
NA,"sobrinho","0","1","0","1","comments-fixed.csv","6"
NA,"spastorino","0","1","0","1","comments-fixed.csv","6"
NA,"sskirby","5","5","95","10","comments-fixed.csv","6"
NA,"stevegraham","4","3","0","7","comments-fixed.csv","6"
NA,"steveklabnik","1","4","47","5","comments-fixed.csv","6"
NA,"tenderlove","26","16","978.039388389388","42","comments-fixed.csv","6"
NA,"thaidn","5","5","0","10","comments-fixed.csv","6"
NA,"thatRD","2","1","46","3","comments-fixed.csv","6"
NA,"twinturbo","0","1","0","1","comments-fixed.csv","6"
NA,"vijaydev","2","3","19.7731601731602","5","comments-fixed.csv","6"
"92","agibralter","0","1","0","1","comments-fixed.csv","7"
NA,"akostrikov","1","1","0","2","comments-fixed.csv","7"
NA,"amarshall","1","1","0","2","comments-fixed.csv","7"
NA,"andrewhubbs","3","2","64","5","comments-fixed.csv","7"
NA,"arturopie","3","1","0","4","comments-fixed.csv","7"
NA,"arunagw","3","4","203.241960507893","7","comments-fixed.csv","7"
NA,"bcardarella","4","3","140.008324360414","7","comments-fixed.csv","7"
NA,"benmmurphy","2","0","0","2","comments-fixed.csv","7"
NA,"bfolkens","1","0","0","1","comments-fixed.csv","7"
NA,"bjornblomqvist","4","1","0","5","comments-fixed.csv","7"
NA,"bogdan","0","2","0","2","comments-fixed.csv","7"
NA,"brianewing","0","3","0","3","comments-fixed.csv","7"
NA,"bryanmikaelian","0","1","0","1","comments-fixed.csv","7"
NA,"butcher","4","1","132.98717948718","5","comments-fixed.csv","7"
NA,"carlosantoniodasilva","16","29","799.343487426755","45","comments-fixed.csv","7"
NA,"cgriego","1","1","0.455067155067155","2","comments-fixed.csv","7"
NA,"chriseppstein","1","1","0","2","comments-fixed.csv","7"
NA,"davidjrice","32","23","331.813771128507","55","comments-fixed.csv","7"
NA,"dazuma","1","1","0","2","comments-fixed.csv","7"
NA,"dchelimsky","5","5","1.80804092421739","10","comments-fixed.csv","7"
NA,"dhh","1","0","0","1","comments-fixed.csv","7"
NA,"dlee","2","2","4.25809850830284","4","comments-fixed.csv","7"
NA,"dmathieu","4","2","198.681845091816","6","comments-fixed.csv","7"
NA,"dolzenko","2","0","0","2","comments-fixed.csv","7"
NA,"drogus","11","19","714.240327975119","30","comments-fixed.csv","7"
NA,"dv","5","1","46.4338993505947","6","comments-fixed.csv","7"
NA,"ebeigarts","1","0","0","1","comments-fixed.csv","7"
NA,"Empact","4","2","0","6","comments-fixed.csv","7"
NA,"Fjan","2","1","0","3","comments-fixed.csv","7"
NA,"Fluxx","0","1","0","1","comments-fixed.csv","7"
NA,"fxn","7","8","261.739051045573","15","comments-fixed.csv","7"
NA,"gampleman","9","3","266","12","comments-fixed.csv","7"
NA,"gregolsen","1","2","7.68115942028986","3","comments-fixed.csv","7"
NA,"guilleiguaran","34","28","830.224616227852","62","comments-fixed.csv","7"
NA,"Hakon","0","1","0","1","comments-fixed.csv","7"
NA,"homakov","2","1","1.71513712840549","3","comments-fixed.csv","7"
NA,"ifesdjeen","0","1","0","1","comments-fixed.csv","7"
NA,"isaacsanders","4","9","170.742344675959","13","comments-fixed.csv","7"
NA,"isabanin","1","1","0","2","comments-fixed.csv","7"
NA,"jcla1","0","1","0","1","comments-fixed.csv","7"
NA,"jcoleman","8","7","814.046410708199","15","comments-fixed.csv","7"
NA,"jeremy","31","17","642.888588779528","48","comments-fixed.csv","7"
NA,"jeremyf","1","2","0","3","comments-fixed.csv","7"
NA,"jeyb","0","1","0","1","comments-fixed.csv","7"
NA,"joe1chen","1","2","79","3","comments-fixed.csv","7"
NA,"JohanB","0","1","0","1","comments-fixed.csv","7"
NA,"jonleighton","3","4","89.3948865285536","7","comments-fixed.csv","7"
NA,"josevalim","50","69","1920.47152155281","119","comments-fixed.csv","7"
NA,"josh","4","2","0","6","comments-fixed.csv","7"
NA,"ka8725","0","1","0","1","comments-fixed.csv","7"
NA,"keithpitt","2","0","0","2","comments-fixed.csv","7"
NA,"kenmazaika","2","0","0","2","comments-fixed.csv","7"
NA,"kennyj","10","15","356.992000521406","25","comments-fixed.csv","7"
NA,"KensoDev","0","1","0","1","comments-fixed.csv","7"
NA,"kierangraham","0","2","0","2","comments-fixed.csv","7"
NA,"krsmurata","1","1","0","2","comments-fixed.csv","7"
NA,"Lte","0","1","0","1","comments-fixed.csv","7"
NA,"luke-gru","0","1","0","1","comments-fixed.csv","7"
NA,"metaskills","0","3","0","3","comments-fixed.csv","7"
NA,"myabc","0","1","0","1","comments-fixed.csv","7"
NA,"nashby","2","2","159","4","comments-fixed.csv","7"
NA,"nertzy","0","1","0","1","comments-fixed.csv","7"
NA,"nlsrchtr","0","1","0","1","comments-fixed.csv","7"
NA,"nmertaugh","1","5","0","6","comments-fixed.csv","7"
NA,"NZKoz","2","1","0","3","comments-fixed.csv","7"
NA,"obie","0","1","0","1","comments-fixed.csv","7"
NA,"panthomakos","2","2","64.9362044817928","4","comments-fixed.csv","7"
NA,"parndt","25","11","1422.82040596951","36","comments-fixed.csv","7"
NA,"patrick99e99","8","7","213.78521709942","15","comments-fixed.csv","7"
NA,"pixeltrix","2","1","64","3","comments-fixed.csv","7"
NA,"rafaelfranca","10","18","858.134727583056","28","comments-fixed.csv","7"
NA,"robyurkowski","0","1","0","1","comments-fixed.csv","7"
NA,"rywall","0","2","0","2","comments-fixed.csv","7"
NA,"samsoffes","0","2","0","2","comments-fixed.csv","7"
NA,"sausman","10","6","177.112211188364","16","comments-fixed.csv","7"
NA,"skojin","1","1","0","2","comments-fixed.csv","7"
NA,"sobrinho","1","1","3.86625548364679","2","comments-fixed.csv","7"
NA,"spastorino","8","5","2.83016498751793","13","comments-fixed.csv","7"
NA,"sskirby","3","2","0","5","comments-fixed.csv","7"
NA,"sstephenson","2","0","0","2","comments-fixed.csv","7"
NA,"steveklabnik","3","6","401.068414918415","9","comments-fixed.csv","7"
NA,"swrobel","0","2","0","2","comments-fixed.csv","7"
NA,"tandem-softworks","4","5","0","9","comments-fixed.csv","7"
NA,"tenderlove","9","6","84.4696183203096","15","comments-fixed.csv","7"
NA,"teohm","4","3","140","7","comments-fixed.csv","7"
NA,"travisbot","0","1","0","1","comments-fixed.csv","7"
NA,"twinturbo","1","1","0","2","comments-fixed.csv","7"
NA,"ugisozols","0","1","0","1","comments-fixed.csv","7"
NA,"vijaydev","1","5","5.88082660732277","6","comments-fixed.csv","7"
NA,"waseem","1","0","0","1","comments-fixed.csv","7"
NA,"wycats","3","1","1.87002801120448","4","comments-fixed.csv","7"
NA,"zenprogrammer","11","3","298.058206844992","14","comments-fixed.csv","7"
"108","abhijeetmisra","0","1","0","1","comments-fixed.csv","8"
NA,"acapilleri","8","3","227.33294069354","11","comments-fixed.csv","8"
NA,"aderyabin","26","9","255.433514681373","35","comments-fixed.csv","8"
NA,"aliix","4","2","4.9527193405054","6","comments-fixed.csv","8"
NA,"amatsuda","4","3","37.3905663277922","7","comments-fixed.csv","8"
NA,"amrnt","0","1","0","1","comments-fixed.csv","8"
NA,"andrewle","0","1","0","1","comments-fixed.csv","8"
NA,"Antiarchitect","8","6","130.160269360269","14","comments-fixed.csv","8"
NA,"arunagw","13","19","387.076803153643","32","comments-fixed.csv","8"
NA,"Aupajo","0","1","0","1","comments-fixed.csv","8"
NA,"bcardarella","17","7","1341.89159531587","24","comments-fixed.csv","8"
NA,"bobbytables","3","1","2.4733692557853","4","comments-fixed.csv","8"
NA,"bogdan","0","1","0","1","comments-fixed.csv","8"
NA,"bopm","1","0","0","1","comments-fixed.csv","8"
NA,"bploetz","3","4","0","7","comments-fixed.csv","8"
NA,"bradediger","1","1","0","2","comments-fixed.csv","8"
NA,"carlosantoniodasilva","15","18","598.57693773688","33","comments-fixed.csv","8"
NA,"charley","0","1","0","1","comments-fixed.csv","8"
NA,"chloerei","0","1","0","1","comments-fixed.csv","8"
NA,"chrisjpowers","0","1","0","1","comments-fixed.csv","8"
NA,"CodeOfficer","0","1","0","1","comments-fixed.csv","8"
NA,"coorasse","0","1","0","1","comments-fixed.csv","8"
NA,"coryschires","0","1","0","1","comments-fixed.csv","8"
NA,"davidcells","1","0","0","1","comments-fixed.csv","8"
NA,"dazuma","1","0","0","1","comments-fixed.csv","8"
NA,"dhh","0","1","0","1","comments-fixed.csv","8"
NA,"diminish7","13","3","11","16","comments-fixed.csv","8"
NA,"dkoprov","0","1","0","1","comments-fixed.csv","8"
NA,"dkubb","0","1","0","1","comments-fixed.csv","8"
NA,"dmathieu","2","1","15.4332026143791","3","comments-fixed.csv","8"
NA,"dreamfall","0","1","0","1","comments-fixed.csv","8"
NA,"drewblas","0","2","0","2","comments-fixed.csv","8"
NA,"drogus","8","16","269.570892778168","24","comments-fixed.csv","8"
NA,"eirc","0","1","0","1","comments-fixed.csv","8"
NA,"Empact","1","1","0","2","comments-fixed.csv","8"
NA,"erichmenge","0","3","0","3","comments-fixed.csv","8"
NA,"ernie","1","2","67.7487792813675","3","comments-fixed.csv","8"
NA,"flackou","0","1","0","1","comments-fixed.csv","8"
NA,"floehopper","0","2","0","2","comments-fixed.csv","8"
NA,"frodsan","1","2","2.4733692557853","3","comments-fixed.csv","8"
NA,"fxn","19","23","495.320713022866","42","comments-fixed.csv","8"
NA,"garygreyling","0","1","0","1","comments-fixed.csv","8"
NA,"gazay","14","6","201.692393143518","20","comments-fixed.csv","8"
NA,"george","0","1","0","1","comments-fixed.csv","8"
NA,"german","0","1","0","1","comments-fixed.csv","8"
NA,"gmcnaughton","1","0","0","1","comments-fixed.csv","8"
NA,"guilleiguaran","0","2","0","2","comments-fixed.csv","8"
NA,"headius","3","1","0","4","comments-fixed.csv","8"
NA,"hoenth","0","1","0","1","comments-fixed.csv","8"
NA,"homakov","1","1","0","2","comments-fixed.csv","8"
NA,"hube","1","0","0","1","comments-fixed.csv","8"
NA,"HugoLnx","4","2","3.01515151515152","6","comments-fixed.csv","8"
NA,"ivanacostarubio","0","1","0","1","comments-fixed.csv","8"
NA,"jacobo","9","2","170.253013462335","11","comments-fixed.csv","8"
NA,"jamesarosen","0","1","0","1","comments-fixed.csv","8"
NA,"jeremy","21","21","1100.50758308254","42","comments-fixed.csv","8"
NA,"jeremyf","2","5","2.8","7","comments-fixed.csv","8"
NA,"jmoline","0","2","0","2","comments-fixed.csv","8"
NA,"jonleighton","8","10","163.843213657089","18","comments-fixed.csv","8"
NA,"jordoh","1","1","0","2","comments-fixed.csv","8"
NA,"josevalim","24","23","1924.30839449162","47","comments-fixed.csv","8"
NA,"joshsz","0","1","0","1","comments-fixed.csv","8"
NA,"kennyj","11","10","52.77943282377","21","comments-fixed.csv","8"
NA,"kevmoo","4","4","0","8","comments-fixed.csv","8"
NA,"kirs","0","2","0","2","comments-fixed.csv","8"
NA,"larzconwell","1","3","0.27719298245614","4","comments-fixed.csv","8"
NA,"leehambley","0","2","0","2","comments-fixed.csv","8"
NA,"luislavena","1","0","0","1","comments-fixed.csv","8"
NA,"marpo60","7","1","103.090909090909","8","comments-fixed.csv","8"
NA,"mildmojo","0","1","0","1","comments-fixed.csv","8"
NA,"mperham","0","1","0","1","comments-fixed.csv","8"
NA,"MSch","1","0","0","1","comments-fixed.csv","8"
NA,"mvanholstyn","0","1","0","1","comments-fixed.csv","8"
NA,"nashby","7","2","185.333569259451","9","comments-fixed.csv","8"
NA,"nerdEd","0","1","0","1","comments-fixed.csv","8"
NA,"nfm","0","1","0","1","comments-fixed.csv","8"
NA,"oscardelben","0","4","0","4","comments-fixed.csv","8"
NA,"PavelDemyanenko","0","2","0","2","comments-fixed.csv","8"
NA,"pixeltrix","3","2","0","5","comments-fixed.csv","8"
NA,"pkananen","0","1","0","1","comments-fixed.csv","8"
NA,"rafaelfranca","14","30","809.155070333782","44","comments-fixed.csv","8"
NA,"rdammkoehler","0","1","0","1","comments-fixed.csv","8"
NA,"rkh","0","1","0","1","comments-fixed.csv","8"
NA,"rohit","1","2","0","3","comments-fixed.csv","8"
NA,"route","4","8","270.754107361611","12","comments-fixed.csv","8"
NA,"samsoffes","1","2","0","3","comments-fixed.csv","8"
NA,"searls","0","1","0","1","comments-fixed.csv","8"
NA,"seeflanigan","0","1","0","1","comments-fixed.csv","8"
NA,"sferik","1","0","0","1","comments-fixed.csv","8"
NA,"shannonrush","0","1","0","1","comments-fixed.csv","8"
NA,"shedd","0","1","0","1","comments-fixed.csv","8"
NA,"shime","0","1","0","1","comments-fixed.csv","8"
NA,"sikachu","1","3","15.3826048951049","4","comments-fixed.csv","8"
NA,"sobrinho","1","1","0","2","comments-fixed.csv","8"
NA,"spastorino","4","3","104.546786546787","7","comments-fixed.csv","8"
NA,"steveklabnik","3","3","856.464516129032","6","comments-fixed.csv","8"
NA,"subelsky","18","2","721","20","comments-fixed.csv","8"
NA,"tenderlove","14","5","320.021752523962","19","comments-fixed.csv","8"
NA,"Tigraine","0","1","0","1","comments-fixed.csv","8"
NA,"timtyrrell","0","1","0","1","comments-fixed.csv","8"
NA,"TimWalker","0","1","0","1","comments-fixed.csv","8"
NA,"tonytonyjan","3","1","0","4","comments-fixed.csv","8"
NA,"travisbot","0","2","0","2","comments-fixed.csv","8"
NA,"travisjeffery","1","1","0","2","comments-fixed.csv","8"
NA,"twinturbo","4","5","4.84638254465841","9","comments-fixed.csv","8"
NA,"vijaydev","2","2","4.09225333800111","4","comments-fixed.csv","8"
NA,"waugh","0","1","0","1","comments-fixed.csv","8"
NA,"wycats","1","0","0","1","comments-fixed.csv","8"
"82","acapilleri","29","29","280.635906985929","58","comments-fixed.csv","9"
NA,"Agis-","0","1","0","1","comments-fixed.csv","9"
NA,"alanhogan","0","1","0","1","comments-fixed.csv","9"
NA,"alexeymuranov","2","4","2.92011741382056","6","comments-fixed.csv","9"
NA,"Antiarchitect","13","13","11.3712630763271","26","comments-fixed.csv","9"
NA,"arunagw","13","12","286.885620953177","25","comments-fixed.csv","9"
NA,"bartvandendriessche","1","1","0","2","comments-fixed.csv","9"
NA,"bcardarella","4","8","0.642847599248191","12","comments-fixed.csv","9"
NA,"blakesmith","5","2","4.47943899782135","7","comments-fixed.csv","9"
NA,"bogdan","20","12","91.4398613029699","32","comments-fixed.csv","9"
NA,"bopm","3","0","0","3","comments-fixed.csv","9"
NA,"carlosantoniodasilva","38","47","705.697882891283","85","comments-fixed.csv","9"
NA,"carlosgaldino","8","4","63","12","comments-fixed.csv","9"
NA,"charliesome","2","1","0","3","comments-fixed.csv","9"
NA,"clowder","0","1","0","1","comments-fixed.csv","9"
NA,"colszowka","0","1","0","1","comments-fixed.csv","9"
NA,"darragh","1","0","0","1","comments-fixed.csv","9"
NA,"daveyeu","1","0","0","1","comments-fixed.csv","9"
NA,"dmathieu","6","11","32.8443337519699","17","comments-fixed.csv","9"
NA,"dominic","0","1","0","1","comments-fixed.csv","9"
NA,"drogus","17","13","312.558685740804","30","comments-fixed.csv","9"
NA,"edtsech","7","5","20.4957280689173","12","comments-fixed.csv","9"
NA,"elia","14","11","65.5171198464703","25","comments-fixed.csv","9"
NA,"erichmenge","1","0","0","1","comments-fixed.csv","9"
NA,"frodsan","16","28","503.366466741997","44","comments-fixed.csv","9"
NA,"fxn","17","16","221.360727669242","33","comments-fixed.csv","9"
NA,"gazay","7","4","74.5605501560143","11","comments-fixed.csv","9"
NA,"gerwtiz","1","1","0","2","comments-fixed.csv","9"
NA,"goshakkk","0","1","0","1","comments-fixed.csv","9"
NA,"guilleiguaran","18","7","471.370691857617","25","comments-fixed.csv","9"
NA,"homakov","35","38","359.866114020473","73","comments-fixed.csv","9"
NA,"iGEL","6","2","5.25611954724369","8","comments-fixed.csv","9"
NA,"iHiD","10","10","0","20","comments-fixed.csv","9"
NA,"jackdempsey","0","1","0","1","comments-fixed.csv","9"
NA,"jaredbeck","4","2","1.50309070467486","6","comments-fixed.csv","9"
NA,"jeremy","54","37","662.559265972693","91","comments-fixed.csv","9"
NA,"jeremyf","2","5","1.81568761183901","7","comments-fixed.csv","9"
NA,"jfirebaugh","2","0","0","2","comments-fixed.csv","9"
NA,"jherdman","0","1","0","1","comments-fixed.csv","9"
NA,"joefiorini","11","4","327.305311397071","15","comments-fixed.csv","9"
NA,"jonleighton","5","3","7.04353889666714","8","comments-fixed.csv","9"
NA,"josevalim","48","54","1008.6689926547","102","comments-fixed.csv","9"
NA,"joshk","1","3","34.4734014402547","4","comments-fixed.csv","9"
NA,"judearasu","0","1","0","1","comments-fixed.csv","9"
NA,"kennyj","11","5","87.0014150026454","16","comments-fixed.csv","9"
NA,"kot-begemot","3","3","0.790892411722884","6","comments-fixed.csv","9"
NA,"kugaevsky","0","1","0","1","comments-fixed.csv","9"
NA,"larzconwell","0","1","0","1","comments-fixed.csv","9"
NA,"lazylester","5","3","64","8","comments-fixed.csv","9"
NA,"lest","1","0","0","1","comments-fixed.csv","9"
NA,"Locke23rus","1","1","0","2","comments-fixed.csv","9"
NA,"Lte","8","10","25.0730894294906","18","comments-fixed.csv","9"
NA,"lucasmazza","0","1","0","1","comments-fixed.csv","9"
NA,"marcandre","1","1","0","2","comments-fixed.csv","9"
NA,"michaelklishin","2","3","36.3483091104032","5","comments-fixed.csv","9"
NA,"mikelikesbikes","1","3","0","4","comments-fixed.csv","9"
NA,"MSNexploder","1","0","0","1","comments-fixed.csv","9"
NA,"nashby","7","6","78.9192825013402","13","comments-fixed.csv","9"
NA,"nertzy","0","1","0","1","comments-fixed.csv","9"
NA,"NZKoz","13","7","73.005460536909","20","comments-fixed.csv","9"
NA,"oscardelben","2","2","2.35166350988065","4","comments-fixed.csv","9"
NA,"paneq","3","5","0","8","comments-fixed.csv","9"
NA,"parndt","4","2","14.6096431346431","6","comments-fixed.csv","9"
NA,"paulcoyle","0","1","0","1","comments-fixed.csv","9"
NA,"pechorin","2","2","0","4","comments-fixed.csv","9"
NA,"pixeltrix","7","7","19.0401458968343","14","comments-fixed.csv","9"
NA,"pokonski","1","1","0","2","comments-fixed.csv","9"
NA,"rafaelfranca","52","79","1164.43972585825","131","comments-fixed.csv","9"
NA,"rajatvig","3","2","0","5","comments-fixed.csv","9"
NA,"rapind","0","1","0","1","comments-fixed.csv","9"
NA,"route","5","6","21.2560659371277","11","comments-fixed.csv","9"
NA,"roytomeij","0","1","0","1","comments-fixed.csv","9"
NA,"sikachu","2","4","0.241996215166947","6","comments-fixed.csv","9"
NA,"sobrinho","1","1","0","2","comments-fixed.csv","9"
NA,"softr8","3","2","0.497754243046254","5","comments-fixed.csv","9"
NA,"spastorino","11","11","23.6192086642171","22","comments-fixed.csv","9"
NA,"steveklabnik","20","32","471.919334750384","52","comments-fixed.csv","9"
NA,"tenderlove","27","17","298.247653643936","44","comments-fixed.csv","9"
NA,"twinturbo","5","8","0","13","comments-fixed.csv","9"
NA,"vijaydev","11","10","274.999593854781","21","comments-fixed.csv","9"
NA,"willbryant","1","1","0","2","comments-fixed.csv","9"
NA,"wycats","1","0","0","1","comments-fixed.csv","9"
"65","aaronchi","1","2","47","3","comments-fixed.csv","10"
NA,"acapilleri","5","4","0","9","comments-fixed.csv","10"
NA,"alexeymuranov","0","1","0","1","comments-fixed.csv","10"
NA,"amatsuda","7","2","142.29196683659","9","comments-fixed.csv","10"
NA,"andmej","1","1","0","2","comments-fixed.csv","10"
NA,"andyl","0","1","0","1","comments-fixed.csv","10"
NA,"arturopie","4","5","0","9","comments-fixed.csv","10"
NA,"arunagw","5","8","128.555080060203","13","comments-fixed.csv","10"
NA,"b4syth","1","1","0","2","comments-fixed.csv","10"
NA,"banister","1","1","46","2","comments-fixed.csv","10"
NA,"boone","1","4","0","5","comments-fixed.csv","10"
NA,"carlosantoniodasilva","22","34","440.805664201675","56","comments-fixed.csv","10"
NA,"carlosbrando","0","1","0","1","comments-fixed.csv","10"
NA,"carlosgaldino","8","6","99.3512237762238","14","comments-fixed.csv","10"
NA,"databyte","1","1","0.278543738381194","2","comments-fixed.csv","10"
NA,"dball","2","2","0","4","comments-fixed.csv","10"
NA,"dmathieu","4","6","69.310289449113","10","comments-fixed.csv","10"
NA,"drogus","17","17","244.945737329863","34","comments-fixed.csv","10"
NA,"emersonrp","11","6","98.4469353047532","17","comments-fixed.csv","10"
NA,"Empact","2","2","0","4","comments-fixed.csv","10"
NA,"erichmenge","2","2","0","4","comments-fixed.csv","10"
NA,"face","0","1","0","1","comments-fixed.csv","10"
NA,"frodsan","20","14","253.066860038036","34","comments-fixed.csv","10"
NA,"fxn","1","1","0","2","comments-fixed.csv","10"
NA,"gaelian","2","2","0","4","comments-fixed.csv","10"
NA,"goshakkk","3","4","0","7","comments-fixed.csv","10"
NA,"guilleiguaran","0","1","0","1","comments-fixed.csv","10"
NA,"homakov","14","16","343.638358148147","30","comments-fixed.csv","10"
NA,"jdelStrother","1","0","0","1","comments-fixed.csv","10"
NA,"jeremy","3","0","0","3","comments-fixed.csv","10"
NA,"jonleighton","3","1","0.168264462809917","4","comments-fixed.csv","10"
NA,"josevalim","22","19","319.741078069201","41","comments-fixed.csv","10"
NA,"jtarchie","1","0","0","1","comments-fixed.csv","10"
NA,"kennyj","15","17","240.504654001949","32","comments-fixed.csv","10"
NA,"KieranP","0","1","0","1","comments-fixed.csv","10"
NA,"ktheory","0","1","0","1","comments-fixed.csv","10"
NA,"kuraga","2","4","0.666666666666667","6","comments-fixed.csv","10"
NA,"LTe","0","1","0","1","comments-fixed.csv","10"
NA,"Mange","0","1","0","1","comments-fixed.csv","10"
NA,"minaguib","2","0","0","2","comments-fixed.csv","10"
NA,"mpapis","2","3","0.774629231537576","5","comments-fixed.csv","10"
NA,"paneq","12","10","196.015240004827","22","comments-fixed.csv","10"
NA,"parndt","25","16","391.603810200978","41","comments-fixed.csv","10"
NA,"PavelDemyanenko","0","1","0","1","comments-fixed.csv","10"
NA,"pivotal-ghostchips","2","0","0","2","comments-fixed.csv","10"
NA,"pixeltrix","5","4","4.05714285714286","9","comments-fixed.csv","10"
NA,"radar","0","1","0","1","comments-fixed.csv","10"
NA,"rafaelfranca","41","47","1158.00991560888","88","comments-fixed.csv","10"
NA,"rf-","0","1","0","1","comments-fixed.csv","10"
NA,"route","9","13","89.8944911672137","22","comments-fixed.csv","10"
NA,"rwfitzge","2","0","0","2","comments-fixed.csv","10"
NA,"sebbacon","6","2","53","8","comments-fixed.csv","10"
NA,"sferik","4","4","49.1339242469521","8","comments-fixed.csv","10"
NA,"shime","0","1","0","1","comments-fixed.csv","10"
NA,"spastorino","3","3","13.8469975950482","6","comments-fixed.csv","10"
NA,"sskirby","7","3","45.6430555555556","10","comments-fixed.csv","10"
NA,"stevecj","8","10","102.013787290862","18","comments-fixed.csv","10"
NA,"steveklabnik","6","14","82.487661521723","20","comments-fixed.csv","10"
NA,"tenderlove","8","0","0","8","comments-fixed.csv","10"
NA,"tgildea","0","1","0","1","comments-fixed.csv","10"
NA,"vijaydev","2","2","0.168264462809917","4","comments-fixed.csv","10"
NA,"wulfovitch","0","1","0","1","comments-fixed.csv","10"
NA,"wuputah","1","0","0","1","comments-fixed.csv","10"
NA,"wycats","3","2","3.57975817286162","5","comments-fixed.csv","10"
NA,"xenda","1","1","0","2","comments-fixed.csv","10"
"77","0x000000","1","1","0","2","comments-fixed.csv","11"
NA,"acapilleri","6","8","257.94190917573","14","comments-fixed.csv","11"
NA,"agraves","5","3","0","8","comments-fixed.csv","11"
NA,"alfredw","1","1","0","2","comments-fixed.csv","11"
NA,"andrewferk","4","4","0","8","comments-fixed.csv","11"
NA,"arunagw","2","3","0.864087468460891","5","comments-fixed.csv","11"
NA,"bcardarella","28","25","630.618052991222","53","comments-fixed.csv","11"
NA,"bogdan","6","2","245.52693719849","8","comments-fixed.csv","11"
NA,"bradediger","1","1","0","2","comments-fixed.csv","11"
NA,"brutuscat","6","8","20.2081041945818","14","comments-fixed.csv","11"
NA,"butzopower","5","2","25.8344865866044","7","comments-fixed.csv","11"
NA,"carlosantoniodasilva","29","50","1109.85855394128","79","comments-fixed.csv","11"
NA,"chancancode","2","5","3.8423207227555","7","comments-fixed.csv","11"
NA,"daniel2d2art","1","2","0","3","comments-fixed.csv","11"
NA,"DarkOne","1","2","0","3","comments-fixed.csv","11"
NA,"davidcells","6","4","220.372678885607","10","comments-fixed.csv","11"
NA,"dhh","1","0","0","1","comments-fixed.csv","11"
NA,"dmathieu","15","9","307.662279249846","24","comments-fixed.csv","11"
NA,"drogus","4","9","224.615276537746","13","comments-fixed.csv","11"
NA,"ebeigarts","1","0","0","1","comments-fixed.csv","11"
NA,"emboss","7","3","10.4455320084641","10","comments-fixed.csv","11"
NA,"emilecantin","0","1","0","1","comments-fixed.csv","11"
NA,"Empact","5","3","0","8","comments-fixed.csv","11"
NA,"epochwolf","0","1","0","1","comments-fixed.csv","11"
NA,"erichmenge","2","2","0","4","comments-fixed.csv","11"
NA,"ernie","0","1","0","1","comments-fixed.csv","11"
NA,"fedesoria","1","1","0","2","comments-fixed.csv","11"
NA,"flexoid","0","1","0","1","comments-fixed.csv","11"
NA,"frodsan","15","14","306.272602877198","29","comments-fixed.csv","11"
NA,"fxn","9","5","17.754864960485","14","comments-fixed.csv","11"
NA,"guilleiguaran","14","10","124.239762824484","24","comments-fixed.csv","11"
NA,"headius","1","2","0","3","comments-fixed.csv","11"
NA,"hermosillorb","4","0","0","4","comments-fixed.csv","11"
NA,"hone","1","0","0","1","comments-fixed.csv","11"
NA,"hube","3","2","0.1","5","comments-fixed.csv","11"
NA,"iGEL","2","1","4.09648303765951","3","comments-fixed.csv","11"
NA,"igrigorik","1","0","0","1","comments-fixed.csv","11"
NA,"insside","3","3","0","6","comments-fixed.csv","11"
NA,"jaredbeck","3","1","2.60573122529644","4","comments-fixed.csv","11"
NA,"jeremy","4","0","0","4","comments-fixed.csv","11"
NA,"jeremycole","4","2","0","6","comments-fixed.csv","11"
NA,"jeyb","3","1","1.47184149184149","4","comments-fixed.csv","11"
NA,"jfoley","0","1","0","1","comments-fixed.csv","11"
NA,"jonleighton","16","9","146.918704748909","25","comments-fixed.csv","11"
NA,"josevalim","23","32","752.733738735554","55","comments-fixed.csv","11"
NA,"kennyj","26","20","117.7164750275","46","comments-fixed.csv","11"
NA,"KL-7","0","1","0","1","comments-fixed.csv","11"
NA,"klobuczek","4","0","0","4","comments-fixed.csv","11"
NA,"kytrinyx","0","1","0","1","comments-fixed.csv","11"
NA,"loz","3","1","1","4","comments-fixed.csv","11"
NA,"macksmind","2","0","0","2","comments-fixed.csv","11"
NA,"mauricio","2","2","0","4","comments-fixed.csv","11"
NA,"Mik-die","2","1","6.46469840714019","3","comments-fixed.csv","11"
NA,"nahi","3","8","20.8910640169281","11","comments-fixed.csv","11"
NA,"NZKoz","11","7","128.201671088768","18","comments-fixed.csv","11"
NA,"paneq","10","6","120.136675648005","16","comments-fixed.csv","11"
NA,"panthomakos","1","0","0","1","comments-fixed.csv","11"
NA,"parndt","2","0","0","2","comments-fixed.csv","11"
NA,"piglop","1","0","0","1","comments-fixed.csv","11"
NA,"pixeltrix","5","4","55","9","comments-fixed.csv","11"
NA,"rafaelfranca","32","65","1186.46674688554","97","comments-fixed.csv","11"
NA,"rosenfeld","5","8","55.9555255235506","13","comments-fixed.csv","11"
NA,"rsim","1","0","0","1","comments-fixed.csv","11"
NA,"seanbehan","2","3","0","5","comments-fixed.csv","11"
NA,"sobrinho","0","1","0","1","comments-fixed.csv","11"
NA,"spastorino","6","4","8.3278113463746","10","comments-fixed.csv","11"
NA,"splattael","1","2","0","3","comments-fixed.csv","11"
NA,"steveklabnik","3","7","131.38298385481","10","comments-fixed.csv","11"
NA,"stiller","3","3","38.8958369058088","6","comments-fixed.csv","11"
NA,"tenderlove","18","15","364.120231169324","33","comments-fixed.csv","11"
NA,"thedarkone","9","4","241.856585289698","13","comments-fixed.csv","11"
NA,"vrish88","1","1","0","2","comments-fixed.csv","11"
NA,"wuputah","0","2","0","2","comments-fixed.csv","11"
NA,"wycats","4","0","0","4","comments-fixed.csv","11"
NA,"yahonda","1","2","110","3","comments-fixed.csv","11"
NA,"zapnap","0","1","0","1","comments-fixed.csv","11"
NA,"zephyr-dev","2","2","0.599745974343627","4","comments-fixed.csv","11"
