"txt","person","inDegree","outDegree","betweenness","totalDegree","timeperiod","timeperiodNum"
"38","amatsuda","4","2","66","6","all-fixed.csv","0"
NA,"Arsen7","1","1","0","2","all-fixed.csv","0"
NA,"arunagw","1","1","0","2","all-fixed.csv","0"
NA,"bogdan","8","4","228","12","all-fixed.csv","0"
NA,"bradediger","1","1","0","2","all-fixed.csv","0"
NA,"butcher","4","1","24","5","all-fixed.csv","0"
NA,"carlosantoniodasilva","1","2","0","3","all-fixed.csv","0"
NA,"dasch","2","4","100","6","all-fixed.csv","0"
NA,"dmathieu","6","4","173","10","all-fixed.csv","0"
NA,"fxn","0","2","0","2","all-fixed.csv","0"
NA,"guilleiguaran","9","16","235.666666666667","25","all-fixed.csv","0"
NA,"idoru","0","1","0","1","all-fixed.csv","0"
NA,"isaacsanders","7","8","237.333333333333","15","all-fixed.csv","0"
NA,"jasonnoble","0","1","0","1","all-fixed.csv","0"
NA,"jeremy","1","1","0","2","all-fixed.csv","0"
NA,"jonleighton","3","2","4","5","all-fixed.csv","0"
NA,"josevalim","5","12","312.333333333333","17","all-fixed.csv","0"
NA,"josh","1","0","0","1","all-fixed.csv","0"
NA,"lautis","1","1","0","2","all-fixed.csv","0"
NA,"marcofognog","0","1","0","1","all-fixed.csv","0"
NA,"paneq","5","2","108","7","all-fixed.csv","0"
NA,"pivotal-casebook","6","0","0","6","all-fixed.csv","0"
NA,"pixeltrix","2","4","70","6","all-fixed.csv","0"
NA,"rafaelfranca","0","3","0","3","all-fixed.csv","0"
NA,"ragaskar","1","1","0","2","all-fixed.csv","0"
NA,"route","0","1","0","1","all-fixed.csv","0"
NA,"rsim","0","3","0","3","all-fixed.csv","0"
NA,"rupurt","0","1","0","1","all-fixed.csv","0"
NA,"siong1987","2","2","0","4","all-fixed.csv","0"
NA,"spastorino","6","5","2.18181818181818","11","all-fixed.csv","0"
NA,"steveklabnik","2","4","0","6","all-fixed.csv","0"
NA,"tekwiz","1","1","7.66666666666667","2","all-fixed.csv","0"
NA,"tenderlove","14","3","176.484848484849","17","all-fixed.csv","0"
NA,"thedarkone","1","1","0","2","all-fixed.csv","0"
NA,"thinkerbot","3","1","22.6666666666667","4","all-fixed.csv","0"
NA,"toddboom","0","1","0","1","all-fixed.csv","0"
NA,"vijaydev","2","3","120.666666666667","5","all-fixed.csv","0"
NA,"wycats","1","0","0","1","all-fixed.csv","0"
"77","aaronchi","3","1","18.5","4","all-fixed.csv","1"
NA,"abachman","0","1","0","1","all-fixed.csv","1"
NA,"adrpac","0","1","0","1","all-fixed.csv","1"
NA,"artemave","13","1","351","14","all-fixed.csv","1"
NA,"arunagw","3","6","114.561879297173","9","all-fixed.csv","1"
NA,"betelgeuse","2","1","38","3","all-fixed.csv","1"
NA,"brendon","0","2","0","2","all-fixed.csv","1"
NA,"brianmario","0","1","0","1","all-fixed.csv","1"
NA,"btelles","0","1","0","1","all-fixed.csv","1"
NA,"carlosantoniodasilva","3","3","96.8083028083028","6","all-fixed.csv","1"
NA,"cgriego","7","3","204.546031746032","10","all-fixed.csv","1"
NA,"chriseppstein","0","1","0","1","all-fixed.csv","1"
NA,"christianblais","4","0","0","4","all-fixed.csv","1"
NA,"ChristianPeters","0","1","0","1","all-fixed.csv","1"
NA,"derekprior","7","6","216.418547740287","13","all-fixed.csv","1"
NA,"dhh","4","5","0","9","all-fixed.csv","1"
NA,"dmathieu","24","21","749.548263755084","45","all-fixed.csv","1"
NA,"elomarns","0","1","0","1","all-fixed.csv","1"
NA,"et","0","1","0","1","all-fixed.csv","1"
NA,"frodsan","0","2","0","2","all-fixed.csv","1"
NA,"fxn","4","3","3.96571938203874","7","all-fixed.csv","1"
NA,"grosser","0","1","0","1","all-fixed.csv","1"
NA,"guilleiguaran","52","41","1064.17990673609","93","all-fixed.csv","1"
NA,"hzeus","0","1","0","1","all-fixed.csv","1"
NA,"isaacsanders","1","1","0","2","all-fixed.csv","1"
NA,"ivanvanderbyl","1","1","0","2","all-fixed.csv","1"
NA,"jeremyevans","0","2","0","2","all-fixed.csv","1"
NA,"jeremyf","0","1","0","1","all-fixed.csv","1"
NA,"joeljunstrom","1","2","0","3","all-fixed.csv","1"
NA,"jonleighton","16","14","803.196135181206","30","all-fixed.csv","1"
NA,"josevalim","14","23","358.956474508786","37","all-fixed.csv","1"
NA,"josh","7","13","19.4040779174039","20","all-fixed.csv","1"
NA,"jsanders","1","1","0","2","all-fixed.csv","1"
NA,"kirel","0","1","0","1","all-fixed.csv","1"
NA,"kirs","2","2","18.5","4","all-fixed.csv","1"
NA,"KlausTrainer","1","1","0","2","all-fixed.csv","1"
NA,"kule","0","1","0","1","all-fixed.csv","1"
NA,"markembling","2","3","0","5","all-fixed.csv","1"
NA,"mbravorus","0","1","0","1","all-fixed.csv","1"
NA,"mirceapricop","0","1","0","1","all-fixed.csv","1"
NA,"moiristo","0","1","0","1","all-fixed.csv","1"
NA,"mtoledo","1","0","0","1","all-fixed.csv","1"
NA,"nateware","0","1","0","1","all-fixed.csv","1"
NA,"nbarthelemy","1","2","0","3","all-fixed.csv","1"
NA,"NiFi","0","1","0","1","all-fixed.csv","1"
NA,"Ninju","1","1","0","2","all-fixed.csv","1"
NA,"NZKoz","2","0","0","2","all-fixed.csv","1"
NA,"ohwillie","0","1","0","1","all-fixed.csv","1"
NA,"oscardelben","0","1","0","1","all-fixed.csv","1"
NA,"osegrums","0","1","0","1","all-fixed.csv","1"
NA,"parndt","7","8","286.871775367831","15","all-fixed.csv","1"
NA,"pcg79","0","1","0","1","all-fixed.csv","1"
NA,"pdelanauze","0","1","0","1","all-fixed.csv","1"
NA,"pixeltrix","3","2","169","5","all-fixed.csv","1"
NA,"pwim","0","1","0","1","all-fixed.csv","1"
NA,"radar","1","1","0","2","all-fixed.csv","1"
NA,"rafaelfranca","4","11","514.204834433095","15","all-fixed.csv","1"
NA,"raggi","0","1","0","1","all-fixed.csv","1"
NA,"reqorder","0","1","0","1","all-fixed.csv","1"
NA,"rhulse","2","4","6.49611410601977","6","all-fixed.csv","1"
NA,"seanabrahams","0","1","0","1","all-fixed.csv","1"
NA,"shwoodard","7","1","308","8","all-fixed.csv","1"
NA,"sikachu","4","1","0","5","all-fixed.csv","1"
NA,"spagalioco","2","5","0","7","all-fixed.csv","1"
NA,"spastorino","14","9","258.017933302485","23","all-fixed.csv","1"
NA,"spohlenz","10","18","137.071832396459","28","all-fixed.csv","1"
NA,"sr3d","0","1","0","1","all-fixed.csv","1"
NA,"tarikjn","1","1","0","2","all-fixed.csv","1"
NA,"tenderlove","8","3","462.8129527332","11","all-fixed.csv","1"
NA,"Tho85","16","4","455.21403155688","20","all-fixed.csv","1"
NA,"tiegz","0","3","0","3","all-fixed.csv","1"
NA,"TildeWill","1","0","0","1","all-fixed.csv","1"
NA,"travisp","0","1","0","1","all-fixed.csv","1"
NA,"unimatrixZxero","0","1","0","1","all-fixed.csv","1"
NA,"vijaydev","5","7","88.4707246450998","12","all-fixed.csv","1"
NA,"yaroslav","0","1","0","1","all-fixed.csv","1"
NA,"zenprogrammer","25","17","454.254462386522","42","all-fixed.csv","1"
"35","bestie","3","3","0","6","all-fixed.csv","2"
NA,"bobbytables","2","0","0","2","all-fixed.csv","2"
NA,"bogdan","9","0","0","9","all-fixed.csv","2"
NA,"dasch","1","6","12","7","all-fixed.csv","2"
NA,"davidknezic","0","1","0","1","all-fixed.csv","2"
NA,"dbenhur","2","3","0","5","all-fixed.csv","2"
NA,"dmitriy-kiriyenko","1","3","0","4","all-fixed.csv","2"
NA,"dmitry","0","1","0","1","all-fixed.csv","2"
NA,"eparreno","1","0","0","1","all-fixed.csv","2"
NA,"fxn","2","2","23.5","4","all-fixed.csv","2"
NA,"gmcnaughton","0","1","0","1","all-fixed.csv","2"
NA,"guilleiguaran","9","5","75","14","all-fixed.csv","2"
NA,"homakov","0","3","0","3","all-fixed.csv","2"
NA,"isaacsanders","2","5","92","7","all-fixed.csv","2"
NA,"jacobo","7","2","21","9","all-fixed.csv","2"
NA,"jeremy","4","3","8.5","7","all-fixed.csv","2"
NA,"joevandyk","5","4","46","9","all-fixed.csv","2"
NA,"jonleighton","5","4","27","9","all-fixed.csv","2"
NA,"josevalim","9","14","156","23","all-fixed.csv","2"
NA,"jwulff","0","2","0","2","all-fixed.csv","2"
NA,"kennyj","1","1","0","2","all-fixed.csv","2"
NA,"larzconwell","1","4","0","5","all-fixed.csv","2"
NA,"lawrencepit","8","5","39","13","all-fixed.csv","2"
NA,"monde","1","1","0","2","all-fixed.csv","2"
NA,"oggy","3","0","0","3","all-fixed.csv","2"
NA,"rafaelfranca","0","1","0","1","all-fixed.csv","2"
NA,"seanwalbran","1","1","0","2","all-fixed.csv","2"
NA,"sobrinho","0","2","0","2","all-fixed.csv","2"
NA,"spastorino","1","0","0","1","all-fixed.csv","2"
NA,"steveklabnik","2","2","0","4","all-fixed.csv","2"
NA,"tenderlove","3","0","0","3","all-fixed.csv","2"
NA,"thomasfedb","0","1","0","1","all-fixed.csv","2"
NA,"vijaydev","1","3","0","4","all-fixed.csv","2"
NA,"vjt","0","1","0","1","all-fixed.csv","2"
NA,"willbryant","2","2","24","4","all-fixed.csv","2"
"43","amatsuda","19","8","370.726298701299","27","all-fixed.csv","3"
NA,"bfolkens","2","0","0","2","all-fixed.csv","3"
NA,"blakeeb","2","1","24","3","all-fixed.csv","3"
NA,"bogdan","2","2","0","4","all-fixed.csv","3"
NA,"brentsowers1","0","2","0","2","all-fixed.csv","3"
NA,"carlosantoniodasilva","1","1","0","2","all-fixed.csv","3"
NA,"chriseppstein","6","7","0","13","all-fixed.csv","3"
NA,"danielvlopes","1","2","0","3","all-fixed.csv","3"
NA,"derekprior","5","3","72","8","all-fixed.csv","3"
NA,"dvyjones","2","2","23","4","all-fixed.csv","3"
NA,"fxn","5","4","130.2","9","all-fixed.csv","3"
NA,"gregolsen","7","2","74","9","all-fixed.csv","3"
NA,"guilleiguaran","16","6","217.056060606061","22","all-fixed.csv","3"
NA,"isaacsanders","0","1","0","1","all-fixed.csv","3"
NA,"jdelStrother","13","11","122","24","all-fixed.csv","3"
NA,"jeremy","2","5","84","7","all-fixed.csv","3"
NA,"jfirebaugh","0","1","0","1","all-fixed.csv","3"
NA,"joevandyk","1","2","0","3","all-fixed.csv","3"
NA,"jonleighton","5","10","126.5","15","all-fixed.csv","3"
NA,"josevalim","18","26","521.141017316017","44","all-fixed.csv","3"
NA,"jrochkind","1","1","0","2","all-fixed.csv","3"
NA,"kjohnston","0","1","0","1","all-fixed.csv","3"
NA,"krainboltgreene","7","4","114.087337662338","11","all-fixed.csv","3"
NA,"lest","0","1","0","1","all-fixed.csv","3"
NA,"mkdynamic","0","1","0","1","all-fixed.csv","3"
NA,"nashby","4","4","55.3954545454545","8","all-fixed.csv","3"
NA,"parndt","1","0","0","1","all-fixed.csv","3"
NA,"paulschreiber","0","1","0","1","all-fixed.csv","3"
NA,"qoobaa","0","1","0","1","all-fixed.csv","3"
NA,"rafaelfranca","0","1","0","1","all-fixed.csv","3"
NA,"rapind","0","1","0","1","all-fixed.csv","3"
NA,"robgleeson","1","1","0","2","all-fixed.csv","3"
NA,"ryanlecompte","4","1","24","5","all-fixed.csv","3"
NA,"spastorino","0","1","0","1","all-fixed.csv","3"
NA,"splattael","2","2","0","4","all-fixed.csv","3"
NA,"stevenh512","0","1","0","1","all-fixed.csv","3"
NA,"taelor","0","1","0","1","all-fixed.csv","3"
NA,"taq","0","1","0","1","all-fixed.csv","3"
NA,"tenderlove","4","3","88.05","7","all-fixed.csv","3"
NA,"vijaydev","6","8","182.843831168831","14","all-fixed.csv","3"
NA,"wsouto","0","3","0","3","all-fixed.csv","3"
NA,"wxianfeng","0","1","0","1","all-fixed.csv","3"
NA,"wycats","0","2","0","2","all-fixed.csv","3"
"47","alexeymuranov","17","23","227.11268722119","40","all-fixed.csv","4"
NA,"amatsuda","3","0","0","3","all-fixed.csv","4"
NA,"Antiarchitect","14","4","218.621267238509","18","all-fixed.csv","4"
NA,"arunagw","10","11","56.1373514466924","21","all-fixed.csv","4"
NA,"Bazai","0","1","0","1","all-fixed.csv","4"
NA,"benmmurphy","10","9","217","19","all-fixed.csv","4"
NA,"bogdan","2","0","0","2","all-fixed.csv","4"
NA,"borisd","3","0","0","3","all-fixed.csv","4"
NA,"carlosantoniodasilva","2","5","48.0277951933124","7","all-fixed.csv","4"
NA,"carlosramireziii","0","1","0","1","all-fixed.csv","4"
NA,"drogus","5","8","106.577460517765","13","all-fixed.csv","4"
NA,"dvandersluis","2","3","0","5","all-fixed.csv","4"
NA,"dvyjones","2","2","0","4","all-fixed.csv","4"
NA,"egilburg","0","2","0","2","all-fixed.csv","4"
NA,"freegenie","1","1","0","2","all-fixed.csv","4"
NA,"fxn","4","1","0","5","all-fixed.csv","4"
NA,"gazay","3","2","100","5","all-fixed.csv","4"
NA,"guilleiguaran","7","10","191.646643717728","17","all-fixed.csv","4"
NA,"isaacsanders","2","5","53.6703296703297","7","all-fixed.csv","4"
NA,"jcoleman","1","0","0","1","all-fixed.csv","4"
NA,"jdelStrother","4","0","0","4","all-fixed.csv","4"
NA,"jeremy","1","2","37.5","3","all-fixed.csv","4"
NA,"jonleighton","17","5","1.42452161587527","22","all-fixed.csv","4"
NA,"josevalim","20","25","545.253638599169","45","all-fixed.csv","4"
NA,"juwalter","1","1","0","2","all-fixed.csv","4"
NA,"kevinzen","0","1","0","1","all-fixed.csv","4"
NA,"kirs","1","2","0","3","all-fixed.csv","4"
NA,"KODerFunk","0","1","0","1","all-fixed.csv","4"
NA,"kommen","2","2","0","4","all-fixed.csv","4"
NA,"lawrencepit","1","2","0","3","all-fixed.csv","4"
NA,"lest","4","9","111.889811912226","13","all-fixed.csv","4"
NA,"mferrier","0","1","0","1","all-fixed.csv","4"
NA,"nashby","15","10","119.966800843929","25","all-fixed.csv","4"
NA,"orslumen","0","1","0","1","all-fixed.csv","4"
NA,"parndt","0","1","0","1","all-fixed.csv","4"
NA,"pdjota","2","3","0","5","all-fixed.csv","4"
NA,"pederbl","1","0","0","1","all-fixed.csv","4"
NA,"petervandenabeele","2","2","2.92857142857143","4","all-fixed.csv","4"
NA,"qoobaa","0","1","0","1","all-fixed.csv","4"
NA,"rafaelfranca","0","2","0","2","all-fixed.csv","4"
NA,"rdp","1","0","0","1","all-fixed.csv","4"
NA,"sferik","0","1","0","1","all-fixed.csv","4"
NA,"spastorino","1","1","56","2","all-fixed.csv","4"
NA,"steveklabnik","0","2","0","2","all-fixed.csv","4"
NA,"tenderlove","12","10","456.882081633665","22","all-fixed.csv","4"
NA,"vijaydev","8","8","72.0277056277056","16","all-fixed.csv","4"
NA,"wycats","2","2","1.33333333333333","4","all-fixed.csv","4"
"49","aceofspades","1","1","34","2","all-fixed.csv","5"
NA,"alexeymuranov","25","32","170.0932260019","57","all-fixed.csv","5"
NA,"amatsuda","11","4","91.3021882596821","15","all-fixed.csv","5"
NA,"arunagw","7","6","110.188255917752","13","all-fixed.csv","5"
NA,"bogdan","6","5","60.5718051038506","11","all-fixed.csv","5"
NA,"brentsowers1","0","1","0","1","all-fixed.csv","5"
NA,"carlosantoniodasilva","17","27","495.704969312485","44","all-fixed.csv","5"
NA,"danchoi","3","3","109","6","all-fixed.csv","5"
NA,"despo","0","1","0","1","all-fixed.csv","5"
NA,"dmathieu","2","1","1.22753458002845","3","all-fixed.csv","5"
NA,"dnagir","0","1","0","1","all-fixed.csv","5"
NA,"drogus","0","1","0","1","all-fixed.csv","5"
NA,"elia","4","5","152","9","all-fixed.csv","5"
NA,"frodsan","1","2","0","3","all-fixed.csv","5"
NA,"fu-media","0","1","0","1","all-fixed.csv","5"
NA,"fxn","2","0","0","2","all-fixed.csv","5"
NA,"gregolsen","4","1","3.90444444444444","5","all-fixed.csv","5"
NA,"guilleiguaran","10","5","146.013750645315","15","all-fixed.csv","5"
NA,"huerlisi","0","1","0","1","all-fixed.csv","5"
NA,"iHiD","6","3","68.4449301515038","9","all-fixed.csv","5"
NA,"isaacsanders","1","1","0","2","all-fixed.csv","5"
NA,"j-manu","12","7","299.122131929695","19","all-fixed.csv","5"
NA,"jasonnoble","1","1","0","2","all-fixed.csv","5"
NA,"jdelStrother","2","1","4.25261464199517","3","all-fixed.csv","5"
NA,"jeremy","27","21","144.145623646216","48","all-fixed.csv","5"
NA,"jm","4","2","2.26953223767383","6","all-fixed.csv","5"
NA,"joevandyk","0","1","0","1","all-fixed.csv","5"
NA,"jonleighton","8","11","115.445162881897","19","all-fixed.csv","5"
NA,"josevalim","16","30","494.380122679879","46","all-fixed.csv","5"
NA,"jrochkind","2","2","0","4","all-fixed.csv","5"
NA,"jwarchol","1","1","0","2","all-fixed.csv","5"
NA,"lawrencepit","2","1","0","3","all-fixed.csv","5"
NA,"lest","3","3","41.0428571428571","6","all-fixed.csv","5"
NA,"mikelikesbikes","0","2","0","2","all-fixed.csv","5"
NA,"mipearson","1","1","0","2","all-fixed.csv","5"
NA,"nashby","10","8","54.7252841811866","18","all-fixed.csv","5"
NA,"nfm","0","1","0","1","all-fixed.csv","5"
NA,"parndt","2","1","0","3","all-fixed.csv","5"
NA,"rafaelfranca","11","17","216.01142365771","28","all-fixed.csv","5"
NA,"simonc","0","1","0","1","all-fixed.csv","5"
NA,"spastorino","6","4","44.0116286012838","10","all-fixed.csv","5"
NA,"splattael","0","1","0","1","all-fixed.csv","5"
NA,"steakknife","0","1","0","1","all-fixed.csv","5"
NA,"steveklabnik","0","1","0","1","all-fixed.csv","5"
NA,"swrobel","2","4","0","6","all-fixed.csv","5"
NA,"tenderlove","24","10","363.521276299847","34","all-fixed.csv","5"
NA,"vijaydev","8","7","41.6212376827991","15","all-fixed.csv","5"
NA,"wycats","1","0","0","1","all-fixed.csv","5"
NA,"xuanxu","0","1","0","1","all-fixed.csv","5"
"62","AaronLasseigne","0","1","0","1","all-fixed.csv","6"
NA,"alexeymuranov","2","0","0","2","all-fixed.csv","6"
NA,"arunagw","4","1","10.2599007314525","5","all-fixed.csv","6"
NA,"benmmurphy","4","2","0","6","all-fixed.csv","6"
NA,"blackbird07","1","2","0","3","all-fixed.csv","6"
NA,"bogdan","7","4","99","11","all-fixed.csv","6"
NA,"bradediger","4","2","48","6","all-fixed.csv","6"
NA,"canweriotnow","0","1","0","1","all-fixed.csv","6"
NA,"carlosantoniodasilva","12","10","344.142755392756","22","all-fixed.csv","6"
NA,"chris-baynes","3","3","0","6","all-fixed.csv","6"
NA,"conradwt","1","1","0","2","all-fixed.csv","6"
NA,"dlee","10","5","335","15","all-fixed.csv","6"
NA,"drogus","1","2","40.5854700854701","3","all-fixed.csv","6"
NA,"exviva","1","1","0","2","all-fixed.csv","6"
NA,"frodsan","0","1","0","1","all-fixed.csv","6"
NA,"funny-falcon","2","1","0","3","all-fixed.csv","6"
NA,"fxn","9","13","612.844516565247","22","all-fixed.csv","6"
NA,"gregolsen","1","1","0","2","all-fixed.csv","6"
NA,"guilleiguaran","5","10","118.950793650794","15","all-fixed.csv","6"
NA,"headius","1","0","0","1","all-fixed.csv","6"
NA,"hmcfletch","7","2","264.51452991453","9","all-fixed.csv","6"
NA,"homakov","3","2","12","5","all-fixed.csv","6"
NA,"houen","0","1","0","1","all-fixed.csv","6"
NA,"igrigorik","1","0","0","1","all-fixed.csv","6"
NA,"iHiD","2","3","0","5","all-fixed.csv","6"
NA,"indrekj","0","1","0","1","all-fixed.csv","6"
NA,"isaacsanders","1","7","5.50268842268842","8","all-fixed.csv","6"
NA,"jeremy","4","3","101.181196581197","7","all-fixed.csv","6"
NA,"jeremyf","1","7","67.3782654127482","8","all-fixed.csv","6"
NA,"jkaneacumen","0","2","0","2","all-fixed.csv","6"
NA,"joevandyk","9","8","115.091316526611","17","all-fixed.csv","6"
NA,"jonleighton","9","2","122.925655716832","11","all-fixed.csv","6"
NA,"josevalim","19","27","813.989866821631","46","all-fixed.csv","6"
NA,"kennyj","22","18","1293.8386132206","40","all-fixed.csv","6"
NA,"kreynolds","2","0","0","2","all-fixed.csv","6"
NA,"lest","1","3","0","4","all-fixed.csv","6"
NA,"lloeki","0","1","0","1","all-fixed.csv","6"
NA,"markiz","1","3","0","4","all-fixed.csv","6"
NA,"masterkain","0","2","0","2","all-fixed.csv","6"
NA,"Mik-die","1","0","0","1","all-fixed.csv","6"
NA,"mledom","1","1","0","2","all-fixed.csv","6"
NA,"nashby","4","3","21.5543201243201","7","all-fixed.csv","6"
NA,"ncreuschling","1","1","0","2","all-fixed.csv","6"
NA,"nicksieger","1","0","0","1","all-fixed.csv","6"
NA,"NZKoz","6","9","203.166666666667","15","all-fixed.csv","6"
NA,"parndt","3","2","83.7978077478078","5","all-fixed.csv","6"
NA,"patrick99e99","7","6","156.085539210245","13","all-fixed.csv","6"
NA,"paukul","1","0","0","1","all-fixed.csv","6"
NA,"Pliny","2","1","0","3","all-fixed.csv","6"
NA,"radar","0","2","0","2","all-fixed.csv","6"
NA,"rafaelfranca","4","7","272.870442433384","11","all-fixed.csv","6"
NA,"rinaldifonseca","2","1","0","3","all-fixed.csv","6"
NA,"sobrinho","0","1","0","1","all-fixed.csv","6"
NA,"spastorino","2","3","65.2617579445571","5","all-fixed.csv","6"
NA,"sskirby","5","5","99","10","all-fixed.csv","6"
NA,"stevegraham","4","3","0","7","all-fixed.csv","6"
NA,"steveklabnik","1","4","49","5","all-fixed.csv","6"
NA,"tenderlove","26","18","1059.64426046683","44","all-fixed.csv","6"
NA,"thaidn","5","5","0","10","all-fixed.csv","6"
NA,"thatRD","2","1","48","3","all-fixed.csv","6"
NA,"twinturbo","0","1","0","1","all-fixed.csv","6"
NA,"vijaydev","2","3","22.4136363636364","5","all-fixed.csv","6"
"93","agibralter","0","1","0","1","all-fixed.csv","7"
NA,"akostrikov","1","1","0","2","all-fixed.csv","7"
NA,"amarshall","1","1","0","2","all-fixed.csv","7"
NA,"andrewhubbs","3","2","65","5","all-fixed.csv","7"
NA,"arturopie","3","1","0","4","all-fixed.csv","7"
NA,"arunagw","3","4","193.698162367812","7","all-fixed.csv","7"
NA,"bcardarella","4","3","29.7672465219477","7","all-fixed.csv","7"
NA,"benmmurphy","2","0","0","2","all-fixed.csv","7"
NA,"bfolkens","1","0","0","1","all-fixed.csv","7"
NA,"bjornblomqvist","4","1","0","5","all-fixed.csv","7"
NA,"bogdan","0","2","0","2","all-fixed.csv","7"
NA,"brianewing","0","3","0","3","all-fixed.csv","7"
NA,"bryanmikaelian","0","1","0","1","all-fixed.csv","7"
NA,"butcher","4","1","134.950980392157","5","all-fixed.csv","7"
NA,"carlosantoniodasilva","25","36","1129.80645820611","61","all-fixed.csv","7"
NA,"cgriego","1","1","0.426996979628559","2","all-fixed.csv","7"
NA,"chriseppstein","1","1","0","2","all-fixed.csv","7"
NA,"davidjrice","32","23","336.233894852295","55","all-fixed.csv","7"
NA,"dazuma","1","1","0","2","all-fixed.csv","7"
NA,"dchelimsky","5","5","1.76045817491051","10","all-fixed.csv","7"
NA,"dhh","1","0","0","1","all-fixed.csv","7"
NA,"dlee","2","2","3.20207691429875","4","all-fixed.csv","7"
NA,"dmathieu","4","2","199.949513845833","6","all-fixed.csv","7"
NA,"dolzenko","2","0","0","2","all-fixed.csv","7"
NA,"drogus","13","21","754.332152431237","34","all-fixed.csv","7"
NA,"dv","5","1","47.6847935383741","6","all-fixed.csv","7"
NA,"ebeigarts","1","0","0","1","all-fixed.csv","7"
NA,"Empact","4","2","0","6","all-fixed.csv","7"
NA,"Fjan","2","1","0","3","all-fixed.csv","7"
NA,"Fluxx","0","1","0","1","all-fixed.csv","7"
NA,"fxn","7","8","266.125625864661","15","all-fixed.csv","7"
NA,"gampleman","9","3","270","12","all-fixed.csv","7"
NA,"gregolsen","1","2","7.59782608695652","3","all-fixed.csv","7"
NA,"guilleiguaran","35","30","745.083025509862","65","all-fixed.csv","7"
NA,"Hakon","0","1","0","1","all-fixed.csv","7"
NA,"homakov","2","1","1.71513712840549","3","all-fixed.csv","7"
NA,"ifesdjeen","0","1","0","1","all-fixed.csv","7"
NA,"isaacsanders","4","9","68.6244108681555","13","all-fixed.csv","7"
NA,"isabanin","1","1","0","2","all-fixed.csv","7"
NA,"jcla1","0","1","0","1","all-fixed.csv","7"
NA,"jcoleman","8","7","813.026000786055","15","all-fixed.csv","7"
NA,"jeremy","31","17","599.267844186825","48","all-fixed.csv","7"
NA,"jeremyf","1","2","0","3","all-fixed.csv","7"
NA,"jeyb","0","1","0","1","all-fixed.csv","7"
NA,"joe1chen","1","2","80","3","all-fixed.csv","7"
NA,"JohanB","0","1","0","1","all-fixed.csv","7"
NA,"jonleighton","3","4","86.1398713623026","7","all-fixed.csv","7"
NA,"josevalim","52","70","1810.30039403267","122","all-fixed.csv","7"
NA,"josh","4","2","0","6","all-fixed.csv","7"
NA,"ka8725","0","1","0","1","all-fixed.csv","7"
NA,"keithpitt","2","0","0","2","all-fixed.csv","7"
NA,"kenmazaika","2","0","0","2","all-fixed.csv","7"
NA,"kennyj","10","15","354.528276126423","25","all-fixed.csv","7"
NA,"KensoDev","0","1","0","1","all-fixed.csv","7"
NA,"kierangraham","0","2","0","2","all-fixed.csv","7"
NA,"krsmurata","1","1","0","2","all-fixed.csv","7"
NA,"lest","1","1","0","2","all-fixed.csv","7"
NA,"Lte","0","1","0","1","all-fixed.csv","7"
NA,"luke-gru","0","1","0","1","all-fixed.csv","7"
NA,"metaskills","0","3","0","3","all-fixed.csv","7"
NA,"myabc","0","1","0","1","all-fixed.csv","7"
NA,"nashby","2","2","161","4","all-fixed.csv","7"
NA,"nertzy","0","1","0","1","all-fixed.csv","7"
NA,"nlsrchtr","0","1","0","1","all-fixed.csv","7"
NA,"nmertaugh","1","5","0","6","all-fixed.csv","7"
NA,"NZKoz","4","3","0","7","all-fixed.csv","7"
NA,"obie","0","1","0","1","all-fixed.csv","7"
NA,"panthomakos","2","2","65.9332922824302","4","all-fixed.csv","7"
NA,"parndt","31","19","1411.91544445596","50","all-fixed.csv","7"
NA,"patrick99e99","9","8","339.509771816883","17","all-fixed.csv","7"
NA,"pixeltrix","2","1","65","3","all-fixed.csv","7"
NA,"rafaelfranca","10","18","855.911505364324","28","all-fixed.csv","7"
NA,"robyurkowski","0","1","0","1","all-fixed.csv","7"
NA,"rywall","0","2","0","2","all-fixed.csv","7"
NA,"samsoffes","0","2","0","2","all-fixed.csv","7"
NA,"sausman","10","6","164.522020958394","16","all-fixed.csv","7"
NA,"skojin","1","1","0","2","all-fixed.csv","7"
NA,"sobrinho","1","1","2.62857515322452","2","all-fixed.csv","7"
NA,"spastorino","11","8","3.20531210394294","19","all-fixed.csv","7"
NA,"sskirby","3","2","0","5","all-fixed.csv","7"
NA,"sstephenson","2","0","0","2","all-fixed.csv","7"
NA,"steveklabnik","3","6","402.96917690153","9","all-fixed.csv","7"
NA,"swrobel","0","2","0","2","all-fixed.csv","7"
NA,"tandem-softworks","5","7","0","12","all-fixed.csv","7"
NA,"tenderlove","9","6","75.2225340144968","15","all-fixed.csv","7"
NA,"teohm","4","3","142","7","all-fixed.csv","7"
NA,"travisbot","0","1","0","1","all-fixed.csv","7"
NA,"twinturbo","1","1","0","2","all-fixed.csv","7"
NA,"ugisozols","0","1","0","1","all-fixed.csv","7"
NA,"vijaydev","9","12","80.782443049813","21","all-fixed.csv","7"
NA,"waseem","1","0","0","1","all-fixed.csv","7"
NA,"wycats","3","1","1.80570052582437","4","all-fixed.csv","7"
NA,"zenprogrammer","13","5","344.373077196263","18","all-fixed.csv","7"
"110","abhijeetmisra","0","1","0","1","all-fixed.csv","8"
NA,"acapilleri","10","5","214.518091599888","15","all-fixed.csv","8"
NA,"aderyabin","27","9","214.87863172621","36","all-fixed.csv","8"
NA,"aliix","4","2","1.62682593271184","6","all-fixed.csv","8"
NA,"amatsuda","4","3","31.034925366543","7","all-fixed.csv","8"
NA,"amrnt","0","1","0","1","all-fixed.csv","8"
NA,"andrewle","0","1","0","1","all-fixed.csv","8"
NA,"Antiarchitect","16","11","145.731858400077","27","all-fixed.csv","8"
NA,"arunagw","13","19","393.391554323713","32","all-fixed.csv","8"
NA,"Aupajo","0","1","0","1","all-fixed.csv","8"
NA,"bcardarella","19","8","1446.0693394331","27","all-fixed.csv","8"
NA,"bobbytables","4","1","2.20249627711681","5","all-fixed.csv","8"
NA,"bogdan","0","1","0","1","all-fixed.csv","8"
NA,"bopm","2","0","0","2","all-fixed.csv","8"
NA,"bploetz","3","4","0","7","all-fixed.csv","8"
NA,"bradediger","1","1","0","2","all-fixed.csv","8"
NA,"carlosantoniodasilva","19","26","570.853795659073","45","all-fixed.csv","8"
NA,"charley","0","1","0","1","all-fixed.csv","8"
NA,"chloerei","0","1","0","1","all-fixed.csv","8"
NA,"chrisjpowers","0","1","0","1","all-fixed.csv","8"
NA,"CodeOfficer","0","1","0","1","all-fixed.csv","8"
NA,"coorasse","0","1","0","1","all-fixed.csv","8"
NA,"coryschires","0","1","0","1","all-fixed.csv","8"
NA,"davidcells","1","0","0","1","all-fixed.csv","8"
NA,"dazuma","1","0","0","1","all-fixed.csv","8"
NA,"dhh","0","1","0","1","all-fixed.csv","8"
NA,"diminish7","13","3","11","16","all-fixed.csv","8"
NA,"dkoprov","0","1","0","1","all-fixed.csv","8"
NA,"dkubb","0","1","0","1","all-fixed.csv","8"
NA,"dmathieu","2","1","20.9581662357468","3","all-fixed.csv","8"
NA,"dreamfall","0","1","0","1","all-fixed.csv","8"
NA,"drewblas","0","2","0","2","all-fixed.csv","8"
NA,"drogus","13","23","249.439442790681","36","all-fixed.csv","8"
NA,"eirc","0","1","0","1","all-fixed.csv","8"
NA,"Empact","4","1","0","5","all-fixed.csv","8"
NA,"erichmenge","0","3","0","3","all-fixed.csv","8"
NA,"ernie","1","2","11.2916239316239","3","all-fixed.csv","8"
NA,"flackou","0","1","0","1","all-fixed.csv","8"
NA,"floehopper","0","2","0","2","all-fixed.csv","8"
NA,"frodsan","1","2","2.20249627711681","3","all-fixed.csv","8"
NA,"fxn","19","23","379.127274115806","42","all-fixed.csv","8"
NA,"garygreyling","0","1","0","1","all-fixed.csv","8"
NA,"gazay","49","12","275.294135562091","61","all-fixed.csv","8"
NA,"george","0","1","0","1","all-fixed.csv","8"
NA,"german","0","1","0","1","all-fixed.csv","8"
NA,"gmcnaughton","1","0","0","1","all-fixed.csv","8"
NA,"guilleiguaran","0","2","0","2","all-fixed.csv","8"
NA,"headius","3","1","0","4","all-fixed.csv","8"
NA,"hoenth","0","1","0","1","all-fixed.csv","8"
NA,"homakov","1","1","0","2","all-fixed.csv","8"
NA,"hube","1","0","0","1","all-fixed.csv","8"
NA,"HugoLnx","4","2","1.03308951584814","6","all-fixed.csv","8"
NA,"isaacsanders","2","2","5.32348484848485","4","all-fixed.csv","8"
NA,"ivanacostarubio","0","1","0","1","all-fixed.csv","8"
NA,"jacobo","9","2","122.843918804778","11","all-fixed.csv","8"
NA,"jamesarosen","0","1","0","1","all-fixed.csv","8"
NA,"jeremy","25","54","774.013817941483","79","all-fixed.csv","8"
NA,"jeremyf","3","6","9.33047827805856","9","all-fixed.csv","8"
NA,"jmoline","0","2","0","2","all-fixed.csv","8"
NA,"joevandyk","1","1","0","2","all-fixed.csv","8"
NA,"jonleighton","13","15","148.103742082827","28","all-fixed.csv","8"
NA,"jordoh","1","1","0","2","all-fixed.csv","8"
NA,"josevalim","24","25","1562.29598802865","49","all-fixed.csv","8"
NA,"joshsz","0","1","0","1","all-fixed.csv","8"
NA,"kennyj","23","19","120.415242837237","42","all-fixed.csv","8"
NA,"kevmoo","4","4","0","8","all-fixed.csv","8"
NA,"kirs","0","2","0","2","all-fixed.csv","8"
NA,"larzconwell","3","6","0.7","9","all-fixed.csv","8"
NA,"leehambley","0","2","0","2","all-fixed.csv","8"
NA,"luislavena","1","0","0","1","all-fixed.csv","8"
NA,"marpo60","7","1","105.84","8","all-fixed.csv","8"
NA,"mildmojo","0","1","0","1","all-fixed.csv","8"
NA,"mperham","0","1","0","1","all-fixed.csv","8"
NA,"MSch","1","0","0","1","all-fixed.csv","8"
NA,"mvanholstyn","0","1","0","1","all-fixed.csv","8"
NA,"nashby","7","2","63.2542598734035","9","all-fixed.csv","8"
NA,"nerdEd","0","1","0","1","all-fixed.csv","8"
NA,"nfm","0","1","0","1","all-fixed.csv","8"
NA,"oscardelben","0","4","0","4","all-fixed.csv","8"
NA,"PavelDemyanenko","0","2","0","2","all-fixed.csv","8"
NA,"pixeltrix","3","2","0","5","all-fixed.csv","8"
NA,"pkananen","0","1","0","1","all-fixed.csv","8"
NA,"rafaelfranca","20","38","1241.95686983748","58","all-fixed.csv","8"
NA,"rdammkoehler","0","1","0","1","all-fixed.csv","8"
NA,"rkh","0","1","0","1","all-fixed.csv","8"
NA,"rohit","1","2","0","3","all-fixed.csv","8"
NA,"route","8","9","406.509285822763","17","all-fixed.csv","8"
NA,"samsoffes","1","2","0","3","all-fixed.csv","8"
NA,"searls","0","1","0","1","all-fixed.csv","8"
NA,"seeflanigan","0","1","0","1","all-fixed.csv","8"
NA,"sferik","1","0","0","1","all-fixed.csv","8"
NA,"shannonrush","0","1","0","1","all-fixed.csv","8"
NA,"shedd","0","1","0","1","all-fixed.csv","8"
NA,"shime","0","1","0","1","all-fixed.csv","8"
NA,"sikachu","1","3","6.94057400069408","4","all-fixed.csv","8"
NA,"sobrinho","1","1","0","2","all-fixed.csv","8"
NA,"spastorino","4","3","91.6077876634398","7","all-fixed.csv","8"
NA,"steveklabnik","3","3","890.581818181818","6","all-fixed.csv","8"
NA,"subelsky","18","2","749","20","all-fixed.csv","8"
NA,"tenderlove","15","10","356.298294867504","25","all-fixed.csv","8"
NA,"Tigraine","0","1","0","1","all-fixed.csv","8"
NA,"timtyrrell","0","1","0","1","all-fixed.csv","8"
NA,"TimWalker","0","1","0","1","all-fixed.csv","8"
NA,"tonytonyjan","4","1","0","5","all-fixed.csv","8"
NA,"travisbot","0","2","0","2","all-fixed.csv","8"
NA,"travisjeffery","1","1","0","2","all-fixed.csv","8"
NA,"twinturbo","4","5","4.69446162303305","9","all-fixed.csv","8"
NA,"vijaydev","2","4","5.63622816101016","6","all-fixed.csv","8"
NA,"waugh","0","1","0","1","all-fixed.csv","8"
NA,"wycats","1","0","0","1","all-fixed.csv","8"
"87","acapilleri","37","33","362.61256000344","70","all-fixed.csv","9"
NA,"Agis-","0","1","0","1","all-fixed.csv","9"
NA,"alanhogan","0","1","0","1","all-fixed.csv","9"
NA,"alexeymuranov","3","5","1.74949457108975","8","all-fixed.csv","9"
NA,"Antiarchitect","21","14","10.5233076631451","35","all-fixed.csv","9"
NA,"arunagw","15","14","331.675409182114","29","all-fixed.csv","9"
NA,"bartvandendriessche","2","1","0","3","all-fixed.csv","9"
NA,"bcardarella","4","8","0.689672703766657","12","all-fixed.csv","9"
NA,"blakesmith","5","2","4.4906162464986","7","all-fixed.csv","9"
NA,"bogdan","25","16","237.905485927839","41","all-fixed.csv","9"
NA,"bopm","3","0","0","3","all-fixed.csv","9"
NA,"carlosantoniodasilva","46","60","854.79442855249","106","all-fixed.csv","9"
NA,"carlosgaldino","13","6","68","19","all-fixed.csv","9"
NA,"charliesome","2","1","0","3","all-fixed.csv","9"
NA,"clowder","0","1","0","1","all-fixed.csv","9"
NA,"colszowka","0","1","0","1","all-fixed.csv","9"
NA,"darragh","1","0","0","1","all-fixed.csv","9"
NA,"daveyeu","1","0","0","1","all-fixed.csv","9"
NA,"dmathieu","6","11","45.8390415684146","17","all-fixed.csv","9"
NA,"dominic","0","1","0","1","all-fixed.csv","9"
NA,"drogus","17","14","323.361348810595","31","all-fixed.csv","9"
NA,"edtsech","7","5","19.5614243270261","12","all-fixed.csv","9"
NA,"elia","14","11","44.5061349973542","25","all-fixed.csv","9"
NA,"erichmenge","1","1","0","2","all-fixed.csv","9"
NA,"exviva","1","2","0","3","all-fixed.csv","9"
NA,"frodsan","19","29","530.678979601531","48","all-fixed.csv","9"
NA,"fxn","18","16","226.224700685296","34","all-fixed.csv","9"
NA,"gaurish","1","1","0","2","all-fixed.csv","9"
NA,"gazay","11","7","90.4855730756367","18","all-fixed.csv","9"
NA,"gerwtiz","1","1","0","2","all-fixed.csv","9"
NA,"gmile","1","1","0","2","all-fixed.csv","9"
NA,"goshakkk","0","1","0","1","all-fixed.csv","9"
NA,"guilleiguaran","20","9","608.328379421996","29","all-fixed.csv","9"
NA,"homakov","46","43","549.661170512777","89","all-fixed.csv","9"
NA,"iGEL","6","2","4.86722338918012","8","all-fixed.csv","9"
NA,"iHiD","30","21","0","51","all-fixed.csv","9"
NA,"jackdempsey","0","1","0","1","all-fixed.csv","9"
NA,"jaredbeck","4","2","1.14826989695585","6","all-fixed.csv","9"
NA,"jeremy","62","79","816.849558642639","141","all-fixed.csv","9"
NA,"jeremyf","2","5","1.92999980600413","7","all-fixed.csv","9"
NA,"jfirebaugh","2","0","0","2","all-fixed.csv","9"
NA,"jherdman","0","1","0","1","all-fixed.csv","9"
NA,"joefiorini","15","6","351.82442085155","21","all-fixed.csv","9"
NA,"jonleighton","5","3","7.01178814247277","8","all-fixed.csv","9"
NA,"josevalim","54","62","1061.59662652357","116","all-fixed.csv","9"
NA,"joshk","1","3","41.9613756193577","4","all-fixed.csv","9"
NA,"judearasu","0","1","0","1","all-fixed.csv","9"
NA,"kennyj","12","6","233.802517995535","18","all-fixed.csv","9"
NA,"KensoDev","2","2","0","4","all-fixed.csv","9"
NA,"kot-begemot","3","3","0.453898551293665","6","all-fixed.csv","9"
NA,"kugaevsky","0","1","0","1","all-fixed.csv","9"
NA,"larzconwell","0","1","0","1","all-fixed.csv","9"
NA,"lazylester","5","3","69","8","all-fixed.csv","9"
NA,"lest","1","0","0","1","all-fixed.csv","9"
NA,"Locke23rus","1","1","0","2","all-fixed.csv","9"
NA,"Lte","26","10","37.9611479999933","36","all-fixed.csv","9"
NA,"lucasmazza","0","1","0","1","all-fixed.csv","9"
NA,"marcandre","1","1","0","2","all-fixed.csv","9"
NA,"michaelklishin","2","3","34.8762000878953","5","all-fixed.csv","9"
NA,"mikelikesbikes","1","3","0","4","all-fixed.csv","9"
NA,"mperham","2","1","0.701120448179272","3","all-fixed.csv","9"
NA,"MSNexploder","1","0","0","1","all-fixed.csv","9"
NA,"nashby","14","11","231.748325251025","25","all-fixed.csv","9"
NA,"nertzy","0","1","0","1","all-fixed.csv","9"
NA,"NZKoz","13","7","74.0245974515735","20","all-fixed.csv","9"
NA,"oscardelben","3","4","2.18245738098679","7","all-fixed.csv","9"
NA,"paneq","3","5","0","8","all-fixed.csv","9"
NA,"parndt","4","2","15.1903017062521","6","all-fixed.csv","9"
NA,"paulcoyle","0","1","0","1","all-fixed.csv","9"
NA,"pechorin","2","2","0","4","all-fixed.csv","9"
NA,"pixeltrix","7","7","22.8623355660172","14","all-fixed.csv","9"
NA,"pokonski","1","1","0","2","all-fixed.csv","9"
NA,"rafaelfranca","68","98","1219.89145905984","166","all-fixed.csv","9"
NA,"rajatvig","3","2","0","5","all-fixed.csv","9"
NA,"rapind","0","1","0","1","all-fixed.csv","9"
NA,"route","5","6","19.6311809750355","11","all-fixed.csv","9"
NA,"roytomeij","0","1","0","1","all-fixed.csv","9"
NA,"sikachu","2","4","0.168057799457321","6","all-fixed.csv","9"
NA,"sobrinho","1","1","0","2","all-fixed.csv","9"
NA,"softr8","3","2","0.566387098144068","5","all-fixed.csv","9"
NA,"spastorino","15","18","65.4350906352229","33","all-fixed.csv","9"
NA,"steveklabnik","20","33","484.72427715724","53","all-fixed.csv","9"
NA,"tenderlove","27","17","271.869161295021","44","all-fixed.csv","9"
NA,"twinturbo","5","8","0","13","all-fixed.csv","9"
NA,"vijaydev","16","21","352.634492818546","37","all-fixed.csv","9"
NA,"willbryant","1","1","0","2","all-fixed.csv","9"
NA,"wycats","1","0","0","1","all-fixed.csv","9"
"68","aaronchi","1","2","47","3","all-fixed.csv","10"
NA,"acapilleri","8","7","0","15","all-fixed.csv","10"
NA,"alexeymuranov","0","1","0","1","all-fixed.csv","10"
NA,"amatsuda","7","2","142.926774409391","9","all-fixed.csv","10"
NA,"andmej","1","1","0","2","all-fixed.csv","10"
NA,"andyl","0","1","0","1","all-fixed.csv","10"
NA,"arturopie","4","5","0","9","all-fixed.csv","10"
NA,"arunagw","5","8","112.935486113867","13","all-fixed.csv","10"
NA,"b4syth","1","1","0","2","all-fixed.csv","10"
NA,"banister","1","1","46","2","all-fixed.csv","10"
NA,"boone","1","4","0","5","all-fixed.csv","10"
NA,"carlosantoniodasilva","36","52","548.919346668021","88","all-fixed.csv","10"
NA,"carlosbrando","0","1","0","1","all-fixed.csv","10"
NA,"carlosgaldino","12","7","100.207090583835","19","all-fixed.csv","10"
NA,"databyte","1","1","0.261158292072407","2","all-fixed.csv","10"
NA,"dball","2","2","0","4","all-fixed.csv","10"
NA,"dmathieu","4","7","74.2181626896581","11","all-fixed.csv","10"
NA,"drogus","17","17","227.484445327521","34","all-fixed.csv","10"
NA,"elektronaut","2","1","1","3","all-fixed.csv","10"
NA,"emersonrp","11","6","99.433802894635","17","all-fixed.csv","10"
NA,"Empact","2","2","0","4","all-fixed.csv","10"
NA,"erichmenge","2","2","0","4","all-fixed.csv","10"
NA,"face","0","1","0","1","all-fixed.csv","10"
NA,"frodsan","26","16","258.034118685249","42","all-fixed.csv","10"
NA,"fxn","1","1","0","2","all-fixed.csv","10"
NA,"gaelian","2","2","0","4","all-fixed.csv","10"
NA,"goshakkk","3","4","0","7","all-fixed.csv","10"
NA,"guilleiguaran","0","1","0","1","all-fixed.csv","10"
NA,"homakov","14","16","330.466583661051","30","all-fixed.csv","10"
NA,"jdelStrother","1","0","0","1","all-fixed.csv","10"
NA,"jeremy","3","0","0","3","all-fixed.csv","10"
NA,"jonleighton","3","1","0.153804050355774","4","all-fixed.csv","10"
NA,"josevalim","23","20","222.365738925083","43","all-fixed.csv","10"
NA,"jtarchie","1","0","0","1","all-fixed.csv","10"
NA,"kennyj","21","22","229.691377665131","43","all-fixed.csv","10"
NA,"KieranP","0","1","0","1","all-fixed.csv","10"
NA,"ktheory","0","1","0","1","all-fixed.csv","10"
NA,"kuraga","6","10","0","16","all-fixed.csv","10"
NA,"LTe","0","1","0","1","all-fixed.csv","10"
NA,"Mange","0","1","0","1","all-fixed.csv","10"
NA,"minaguib","2","0","0","2","all-fixed.csv","10"
NA,"mpapis","2","3","0.757152340803867","5","all-fixed.csv","10"
NA,"oscardelben","1","1","0","2","all-fixed.csv","10"
NA,"paneq","12","10","164.159702721727","22","all-fixed.csv","10"
NA,"parndt","25","16","337.978641102518","41","all-fixed.csv","10"
NA,"PavelDemyanenko","0","1","0","1","all-fixed.csv","10"
NA,"pivotal-ghostchips","2","0","0","2","all-fixed.csv","10"
NA,"pixeltrix","5","4","2.10897435897436","9","all-fixed.csv","10"
NA,"presidentbeef","0","1","0","1","all-fixed.csv","10"
NA,"radar","0","1","0","1","all-fixed.csv","10"
NA,"rafaelfranca","51","60","1174.27101835228","111","all-fixed.csv","10"
NA,"rf-","0","1","0","1","all-fixed.csv","10"
NA,"route","9","13","76.5832705507356","22","all-fixed.csv","10"
NA,"rwfitzge","2","0","0","2","all-fixed.csv","10"
NA,"sebbacon","6","2","54","8","all-fixed.csv","10"
NA,"sferik","4","4","50.6405696741638","8","all-fixed.csv","10"
NA,"shime","0","1","0","1","all-fixed.csv","10"
NA,"spastorino","3","3","12.541126492544","6","all-fixed.csv","10"
NA,"sskirby","14","10","73.4930437899947","24","all-fixed.csv","10"
NA,"stevecj","14","15","149.808408546826","29","all-fixed.csv","10"
NA,"steveklabnik","6","14","79.8407784310366","20","all-fixed.csv","10"
NA,"tenderlove","9","1","3.37822140045623","10","all-fixed.csv","10"
NA,"tgildea","0","1","0","1","all-fixed.csv","10"
NA,"vijaydev","3","2","0.153804050355774","5","all-fixed.csv","10"
NA,"wulfovitch","0","1","0","1","all-fixed.csv","10"
NA,"wuputah","1","0","0","1","all-fixed.csv","10"
NA,"wycats","3","2","3.18739822171481","5","all-fixed.csv","10"
NA,"xenda","1","1","0","2","all-fixed.csv","10"
"85","0x000000","1","1","0","2","all-fixed.csv","11"
NA,"acapilleri","10","11","318.456822602007","21","all-fixed.csv","11"
NA,"agraves","5","3","0","8","all-fixed.csv","11"
NA,"alfredw","2","1","0","3","all-fixed.csv","11"
NA,"andmej","0","1","0","1","all-fixed.csv","11"
NA,"andrewferk","11","6","0","17","all-fixed.csv","11"
NA,"arunagw","3","3","70.0324510932105","6","all-fixed.csv","11"
NA,"bcardarella","44","36","1008.60657305004","80","all-fixed.csv","11"
NA,"bogdan","8","3","138.70762931008","11","all-fixed.csv","11"
NA,"bradediger","1","1","0","2","all-fixed.csv","11"
NA,"brutuscat","7","9","92.0841997294623","16","all-fixed.csv","11"
NA,"butzopower","10","5","99.8021338699997","15","all-fixed.csv","11"
NA,"carlosantoniodasilva","43","76","1774.56702960198","119","all-fixed.csv","11"
NA,"chancancode","4","8","8.16272446139886","12","all-fixed.csv","11"
NA,"daniel2d2art","1","2","0","3","all-fixed.csv","11"
NA,"DarkOne","1","2","0","3","all-fixed.csv","11"
NA,"davidcells","6","4","314.50785998972","10","all-fixed.csv","11"
NA,"dhh","1","0","0","1","all-fixed.csv","11"
NA,"dmathieu","19","14","352.258603000765","33","all-fixed.csv","11"
NA,"drogus","6","10","239.203373248297","16","all-fixed.csv","11"
NA,"ebeigarts","1","0","0","1","all-fixed.csv","11"
NA,"emboss","7","3","5.79611233841031","10","all-fixed.csv","11"
NA,"emilecantin","0","1","0","1","all-fixed.csv","11"
NA,"Empact","5","3","0","8","all-fixed.csv","11"
NA,"epochwolf","0","1","0","1","all-fixed.csv","11"
NA,"erichmenge","2","2","0","4","all-fixed.csv","11"
NA,"ernie","0","1","0","1","all-fixed.csv","11"
NA,"exviva","2","3","0","5","all-fixed.csv","11"
NA,"fedesoria","3","3","65","6","all-fixed.csv","11"
NA,"flexoid","0","1","0","1","all-fixed.csv","11"
NA,"foca","2","2","0","4","all-fixed.csv","11"
NA,"frodsan","16","16","287.358748400908","32","all-fixed.csv","11"
NA,"fxn","9","6","22.2295994519505","15","all-fixed.csv","11"
NA,"gmile","1","1","70","2","all-fixed.csv","11"
NA,"guilleiguaran","24","19","358.347455274694","43","all-fixed.csv","11"
NA,"headius","1","2","0","3","all-fixed.csv","11"
NA,"hermosillorb","6","0","0","6","all-fixed.csv","11"
NA,"hone","1","0","0","1","all-fixed.csv","11"
NA,"hube","3","2","0.2","5","all-fixed.csv","11"
NA,"iGEL","3","1","139.873395026027","4","all-fixed.csv","11"
NA,"igrigorik","1","0","0","1","all-fixed.csv","11"
NA,"insside","5","3","1.66553185340756","8","all-fixed.csv","11"
NA,"jaredbeck","3","1","2.83443299136453","4","all-fixed.csv","11"
NA,"jeremy","5","1","3.07707007451838","6","all-fixed.csv","11"
NA,"jeremycole","4","2","0","6","all-fixed.csv","11"
NA,"jeyb","3","1","0","4","all-fixed.csv","11"
NA,"jfoley","1","1","0","2","all-fixed.csv","11"
NA,"jonleighton","16","9","144.883128639695","25","all-fixed.csv","11"
NA,"josevalim","29","36","832.987891394114","65","all-fixed.csv","11"
NA,"kennyj","40","31","128.763363995439","71","all-fixed.csv","11"
NA,"KL-7","0","1","0","1","all-fixed.csv","11"
NA,"klobuczek","4","0","0","4","all-fixed.csv","11"
NA,"kytrinyx","0","1","0","1","all-fixed.csv","11"
NA,"loz","3","1","1","4","all-fixed.csv","11"
NA,"macksmind","2","0","0","2","all-fixed.csv","11"
NA,"mauricio","2","2","0","4","all-fixed.csv","11"
NA,"mguterl","1","1","0","2","all-fixed.csv","11"
NA,"Mik-die","2","1","4.02029684622204","3","all-fixed.csv","11"
NA,"mperham","3","2","0","5","all-fixed.csv","11"
NA,"nahi","3","8","11.5922246768206","11","all-fixed.csv","11"
NA,"NZKoz","12","8","146.901698801396","20","all-fixed.csv","11"
NA,"paneq","12","7","133.666265991838","19","all-fixed.csv","11"
NA,"panthomakos","1","0","0","1","all-fixed.csv","11"
NA,"parndt","3","2","69","5","all-fixed.csv","11"
NA,"piglop","1","0","0","1","all-fixed.csv","11"
NA,"pixeltrix","7","11","65","18","all-fixed.csv","11"
NA,"rafaelfranca","39","73","1062.14792782104","112","all-fixed.csv","11"
NA,"rosenfeld","5","8","11.7505371432438","13","all-fixed.csv","11"
NA,"rsim","1","0","0","1","all-fixed.csv","11"
NA,"seanbehan","2","3","0","5","all-fixed.csv","11"
NA,"sobrinho","0","1","0","1","all-fixed.csv","11"
NA,"spastorino","14","14","106.929790200939","28","all-fixed.csv","11"
NA,"splattael","1","2","0","3","all-fixed.csv","11"
NA,"steveklabnik","3","8","145.298733555192","11","all-fixed.csv","11"
NA,"stevenh512","0","1","0","1","all-fixed.csv","11"
NA,"stiller","4","3","30.2960416572454","7","all-fixed.csv","11"
NA,"tenderlove","29","29","483.287613421765","58","all-fixed.csv","11"
NA,"thedarkone","12","7","265.575278249904","19","all-fixed.csv","11"
NA,"vijaydev","1","1","0","2","all-fixed.csv","11"
NA,"vrish88","1","1","0","2","all-fixed.csv","11"
NA,"wuputah","0","2","0","2","all-fixed.csv","11"
NA,"wycats","4","0","0","4","all-fixed.csv","11"
NA,"yahonda","1","2","130","3","all-fixed.csv","11"
NA,"zapnap","0","1","0","1","all-fixed.csv","11"
NA,"zephyr-dev","4","4","1.1274622369051","8","all-fixed.csv","11"
